drug_name	active_ingredients
ALCOHOL 5% AND DEXTROSE 5%	ALCOHOL; DEXTROSE
ALCOHOL 10% AND DEXTROSE 5%	ALCOHOL; DEXTROSE
HYCODAN	HOMATROPINE METHYLBROMIDE; HYDROCODONE BITARTRATE
SULTRIN	TRIPLE SULFA (SULFABENZAMIDE;SULFACETAMIDE;SULFATHIAZOLE)
FOLVRON	FERROUS SULFATE; FOLIC ACID
BEROCCA PN	ASCORBIC ACID; BIOTIN; CYANOCOBALAMIN; DEXPANTHENOL; ERGOCALCIFEROL; FOLIC ACID; NIACINAMIDE; PYRIDOXINE HYDROCHLORIDE; RIBOFLAVIN 5'-PHOSPHATE SODIUM; THIAMINE HYDROCHLORIDE; VITAMIN A PALMITATE; VITAMIN E
SULFONAMIDES DUPLEX	SULFADIAZINE; SULFAMERAZINE
NEOTRIZINE	TRISULFAPYRIMIDINES (SULFADIAZINE;SULFAMERAZINE;SULFAMETHAZINE)
XYLOCAINE W/ EPINEPHRINE	EPINEPHRINE; LIDOCAINE HYDROCHLORIDE
CAFERGOT	CAFFEINE; ERGOTAMINE TARTRATE
TERFONYL	TRISULFAPYRIMIDINES (SULFADIAZINE;SULFAMERAZINE;SULFAMETHAZINE)
TRIPLE SULFAS	TRISULFAPYRIMIDINES (SULFADIAZINE;SULFAMERAZINE;SULFAMETHAZINE)
PERCODAN-DEMI	ASPIRIN; OXYCODONE HYDROCHLORIDE; OXYCODONE TEREPHTHALATE
PERCODAN	ASPIRIN; OXYCODONE HYDROCHLORIDE
PREFRIN-A	PHENYLEPHRINE HYDROCHLORIDE; PYRILAMINE MALEATE
PHENERGAN W/ CODEINE	CODEINE PHOSPHATE; PROMETHAZINE HYDROCHLORIDE
PHENERGAN VC W/ CODEINE	CODEINE PHOSPHATE; PHENYLEPHRINE HYDROCHLORIDE; PROMETHAZINE HYDROCHLORIDE
TPN	NIACINAMIDE; PYRIDOXINE HYDROCHLORIDE; TYROSINE
RAVOCAINE AND NOVOCAIN W/ LEVOPHED	NOREPINEPHRINE BITARTRATE; PROCAINE HYDROCHLORIDE; PROPOXYCAINE HYDROCHLORIDE
RAVOCAINE AND NOVOCAIN W/ NEO-COBEFRIN	LEVONORDEFRIN; PROCAINE HYDROCHLORIDE; PROPOXYCAINE HYDROCHLORIDE
PHENERGAN VC	PHENYLEPHRINE HYDROCHLORIDE; PROMETHAZINE HYDROCHLORIDE
M.V.I.-12 ADULT	ASCORBIC ACID; BIOTIN; CYANOCOBALAMIN; DEXPANTHENOL; ERGOCALCIFEROL; FOLIC ACID; NIACINAMIDE; PYRIDOXINE HYDROCHLORIDE; RIBOFLAVIN 5'-PHOSPHATE SODIUM; THIAMINE HYDROCHLORIDE; VITAMIN A; VITAMIN E
DICURIN PROCAINE	PROCAINE MERETHOXYLLINE; THEOPHYLLINE
SERPASIL-APRESOLINE	HYDRALAZINE HYDROCHLORIDE; RESERPINE
AMBENYL	BROMODIPHENHYDRAMINE HYDROCHLORIDE; CODEINE PHOSPHATE
RENOGRAFIN-76	DIATRIZOATE MEGLUMINE; DIATRIZOATE SODIUM
RENOGRAFIN-60	DIATRIZOATE MEGLUMINE; DIATRIZOATE SODIUM
RENOVIST II	DIATRIZOATE MEGLUMINE; DIATRIZOATE SODIUM
RENOVIST	DIATRIZOATE MEGLUMINE; DIATRIZOATE SODIUM
BIPHETAMINE 20	AMPHETAMINE RESIN COMPLEX; DEXTROAMPHETAMINE RESIN COMPLEX
BIPHETAMINE 12.5	AMPHETAMINE RESIN COMPLEX; DEXTROAMPHETAMINE RESIN COMPLEX
BIPHETAMINE 7.5	AMPHETAMINE RESIN COMPLEX; DEXTROAMPHETAMINE RESIN COMPLEX
METIMYD	PREDNISOLONE ACETATE; SULFACETAMIDE SODIUM
HYPAQUE-M,90%	DIATRIZOATE MEGLUMINE; DIATRIZOATE SODIUM
HYPAQUE-M,75%	DIATRIZOATE MEGLUMINE; DIATRIZOATE SODIUM
BENDECTIN	DOXYLAMINE SUCCINATE; PYRIDOXINE HYDROCHLORIDE
PMB 400	ESTROGENS, CONJUGATED; MEPROBAMATE
PMB 200	ESTROGENS, CONJUGATED; MEPROBAMATE
ENOVID	MESTRANOL; NORETHYNODREL
ENOVID-E	MESTRANOL; NORETHYNODREL
ENOVID-E 21	MESTRANOL; NORETHYNODREL
DARVON W/ ASA	ASPIRIN; PROPOXYPHENE HYDROCHLORIDE
DARVON COMPOUND	ASPIRIN; CAFFEINE; PROPOXYPHENE HYDROCHLORIDE
DARVON COMPOUND-65	ASPIRIN; CAFFEINE; PROPOXYPHENE HYDROCHLORIDE
MILPREM-400	ESTROGENS, CONJUGATED; MEPROBAMATE
MILPREM-200	ESTROGENS, CONJUGATED; MEPROBAMATE
DEPINAR	CYANOCOBALAMIN; TANNIC ACID; ZINC ACETATE
GASTROGRAFIN	DIATRIZOATE MEGLUMINE; DIATRIZOATE SODIUM
PROMETHAZINE HYDROCHLORIDE AND DEXTROMETHORPHAN HYDROBROMIDE	DEXTROMETHORPHAN HYDROBROMIDE; PROMETHAZINE HYDROCHLORIDE
SINOGRAFIN	DIATRIZOATE MEGLUMINE; IODIPAMIDE MEGLUMINE
SYNALGOS-DC	ASPIRIN; CAFFEINE; DIHYDROCODEINE BITARTRATE
ADDERALL 10	AMPHETAMINE ASPARTATE; AMPHETAMINE SULFATE; DEXTROAMPHETAMINE SACCHARATE; DEXTROAMPHETAMINE SULFATE
ADDERALL 20	AMPHETAMINE ASPARTATE; AMPHETAMINE SULFATE; DEXTROAMPHETAMINE SACCHARATE; DEXTROAMPHETAMINE SULFATE
ADDERALL 5	AMPHETAMINE ASPARTATE; AMPHETAMINE SULFATE; DEXTROAMPHETAMINE SACCHARATE; DEXTROAMPHETAMINE SULFATE
ADDERALL 30	AMPHETAMINE ASPARTATE; AMPHETAMINE SULFATE; DEXTROAMPHETAMINE SACCHARATE; DEXTROAMPHETAMINE SULFATE
ADDERALL 7.5	AMPHETAMINE ASPARTATE; AMPHETAMINE SULFATE; DEXTROAMPHETAMINE SACCHARATE; DEXTROAMPHETAMINE SULFATE
ADDERALL 12.5	AMPHETAMINE ASPARTATE; AMPHETAMINE SULFATE; DEXTROAMPHETAMINE SACCHARATE; DEXTROAMPHETAMINE SULFATE
ADDERALL 15	AMPHETAMINE ASPARTATE; AMPHETAMINE SULFATE; DEXTROAMPHETAMINE SACCHARATE; DEXTROAMPHETAMINE SULFATE
DIUPRES-250	CHLOROTHIAZIDE; RESERPINE
DIUPRES-500	CHLOROTHIAZIDE; RESERPINE
EQUAGESIC	ASPIRIN; MEPROBAMATE
MEPERGAN	MEPERIDINE HYDROCHLORIDE; PROMETHAZINE HYDROCHLORIDE
SERPASIL-ESIDRIX #1	HYDROCHLOROTHIAZIDE; RESERPINE
SERPASIL-ESIDRIX #2	HYDROCHLOROTHIAZIDE; RESERPINE
VIRAC REX	LAPYRIUM CHLORIDE; UNDECOYLIUM CHLORIDE IODINE COMPLEX
HYDROPRES 25	HYDROCHLOROTHIAZIDE; RESERPINE
HYDROPRES 50	HYDROCHLOROTHIAZIDE; RESERPINE
APRESOLINE-ESIDRIX	HYDRALAZINE HYDROCHLORIDE; HYDROCHLOROTHIAZIDE
CARBOCAINE W/ NEO-COBEFRIN	LEVONORDEFRIN; MEPIVACAINE HYDROCHLORIDE
ORETICYL 25	DESERPIDINE; HYDROCHLOROTHIAZIDE
ORETICYL FORTE	DESERPIDINE; HYDROCHLOROTHIAZIDE
ORETICYL 50	DESERPIDINE; HYDROCHLOROTHIAZIDE
SER-AP-ES	HYDRALAZINE HYDROCHLORIDE; HYDROCHLOROTHIAZIDE; RESERPINE
NAQUIVAL	RESERPINE; TRICHLORMETHIAZIDE
ROBAXISAL	ASPIRIN; METHOCARBAMOL
SALUTENSIN	HYDROFLUMETHIAZIDE; RESERPINE
SALUTENSIN-DEMI	HYDROFLUMETHIAZIDE; RESERPINE
SOMA COMPOUND	ASPIRIN; CARISOPRODOL
SOMA COMPOUND W/ CODEINE	ASPIRIN; CARISOPRODOL; CODEINE PHOSPHATE
COLBENEMID	COLCHICINE; PROBENECID
DISOPHROL	DEXBROMPHENIRAMINE MALEATE; PSEUDOEPHEDRINE SULFATE
LOMOTIL	ATROPINE SULFATE; DIPHENOXYLATE HYDROCHLORIDE
ACTIFED W/ CODEINE	CODEINE PHOSPHATE; PSEUDOEPHEDRINE HYDROCHLORIDE; TRIPROLIDINE HYDROCHLORIDE
ALDACTAZIDE	HYDROCHLOROTHIAZIDE; SPIRONOLACTONE
DIUTENSEN-R	METHYCLOTHIAZIDE; RESERPINE
ORTHO-NOVUM 10-21	MESTRANOL; NORETHINDRONE
ORTHO-NOVUM 1/50 21	MESTRANOL; NORETHINDRONE
ORTHO-NOVUM 2-21	MESTRANOL; NORETHINDRONE
LIBRAX	CHLORDIAZEPOXIDE HYDROCHLORIDE; CLIDINIUM BROMIDE
VOSOL HC	ACETIC ACID, GLACIAL; HYDROCORTISONE
ENDURONYL	DESERPIDINE; METHYCLOTHIAZIDE
ENDURONYL FORTE	DESERPIDINE; METHYCLOTHIAZIDE
BLEPHAMIDE	PREDNISOLONE ACETATE; SULFACETAMIDE SODIUM
METATENSIN #2	RESERPINE; TRICHLORMETHIAZIDE
METATENSIN #4	RESERPINE; TRICHLORMETHIAZIDE
THAM-E	POTASSIUM CHLORIDE; SODIUM CHLORIDE; TROMETHAMINE
AZO GANTANOL	PHENAZOPYRIDINE HYDROCHLORIDE; SULFAMETHOXAZOLE
DUO-MEDIHALER	ISOPROTERENOL HYDROCHLORIDE; PHENYLEPHRINE BITARTRATE
DECADRON W/ XYLOCAINE	DEXAMETHASONE SODIUM PHOSPHATE; LIDOCAINE HYDROCHLORIDE
ALDORIL 15	HYDROCHLOROTHIAZIDE; METHYLDOPA
ALDORIL 25	HYDROCHLOROTHIAZIDE; METHYLDOPA
ALDORIL D30	HYDROCHLOROTHIAZIDE; METHYLDOPA
ALDORIL D50	HYDROCHLOROTHIAZIDE; METHYLDOPA
NORGESIC	ASPIRIN; CAFFEINE; ORPHENADRINE CITRATE
NORGESIC FORTE	ASPIRIN; CAFFEINE; ORPHENADRINE CITRATE
DRIXORAL	DEXBROMPHENIRAMINE MALEATE; PSEUDOEPHEDRINE SULFATE
ESIMIL	GUANETHIDINE MONOSULFATE; HYDROCHLOROTHIAZIDE
NORINYL 1+50 21-DAY	MESTRANOL; NORETHINDRONE
NORINYL	MESTRANOL; NORETHINDRONE
RENESE-R	POLYTHIAZIDE; RESERPINE
HYDROMOX R	QUINETHAZONE; RESERPINE
CELESTONE SOLUSPAN	BETAMETHASONE ACETATE; BETAMETHASONE SODIUM PHOSPHATE
ETRAFON-A	AMITRIPTYLINE HYDROCHLORIDE; PERPHENAZINE
ETRAFON 2-25	AMITRIPTYLINE HYDROCHLORIDE; PERPHENAZINE
ETRAFON-FORTE	AMITRIPTYLINE HYDROCHLORIDE; PERPHENAZINE
ETRAFON 2-10	AMITRIPTYLINE HYDROCHLORIDE; PERPHENAZINE
TRIAVIL 2-25	AMITRIPTYLINE HYDROCHLORIDE; PERPHENAZINE
TRIAVIL 4-10	AMITRIPTYLINE HYDROCHLORIDE; PERPHENAZINE
TRIAVIL 2-10	AMITRIPTYLINE HYDROCHLORIDE; PERPHENAZINE
TRIAVIL 4-25	AMITRIPTYLINE HYDROCHLORIDE; PERPHENAZINE
TRIAVIL 4-50	AMITRIPTYLINE HYDROCHLORIDE; PERPHENAZINE
MENRIUM 5-2	CHLORDIAZEPOXIDE; ESTROGENS, ESTERIFIED
MENRIUM 5-4	CHLORDIAZEPOXIDE; ESTROGENS, ESTERIFIED
MENRIUM 10-4	CHLORDIAZEPOXIDE; ESTROGENS, ESTERIFIED
CITANEST FORTE	EPINEPHRINE BITARTRATE; PRILOCAINE HYDROCHLORIDE
ARALEN PHOSPHATE W/ PRIMAQUINE PHOSPHATE	CHLOROQUINE PHOSPHATE; PRIMAQUINE PHOSPHATE
REGROTON	CHLORTHALIDONE; RESERPINE
DEMI-REGROTON	CHLORTHALIDONE; RESERPINE
ALDOCLOR-150	CHLOROTHIAZIDE; METHYLDOPA
ALDOCLOR-250	CHLOROTHIAZIDE; METHYLDOPA
OVULEN	ETHYNODIOL DIACETATE; MESTRANOL
OVULEN-21	ETHYNODIOL DIACETATE; MESTRANOL
DYAZIDE	HYDROCHLOROTHIAZIDE; TRIAMTERENE
EUTRON	METHYCLOTHIAZIDE; PARGYLINE HYDROCHLORIDE
INNOVAR	DROPERIDOL; FENTANYL CITRATE
RUBRATOPE-57 KIT	COBALT CHLORIDE CO-57; CYANOCOBALAMIN; CYANOCOBALAMIN CO-57; INTRINSIC FACTOR
RUBRATOPE-60 KIT	COBALT CHLORIDE CO-60; CYANOCOBALAMIN; CYANOCOBALAMIN CO-60; INTRINSIC FACTOR
CYANOCOBALAMIN CO 57 SCHILLING TEST KIT	CYANOCOBALAMIN; CYANOCOBALAMIN CO-57; INTRINSIC FACTOR
NORINYL 1+50 28-DAY	MESTRANOL; NORETHINDRONE
OVRAL	ETHINYL ESTRADIOL; NORGESTREL
DEXTROSE 5% IN SODIUM CHLORIDE 0.9% IN PLASTIC CONTAINER	DEXTROSE; SODIUM CHLORIDE
LACTATED RINGER'S AND DEXTROSE 5% IN PLASTIC CONTAINER	CALCIUM CHLORIDE; DEXTROSE; POTASSIUM CHLORIDE; SODIUM CHLORIDE; SODIUM LACTATE
EUTHROID-0.5	LIOTRIX (T4;T3)
EUTHROID-1	LIOTRIX (T4;T3)
EUTHROID-2	LIOTRIX (T4;T3)
EUTHROID-3	LIOTRIX (T4;T3)
LACTATED RINGER'S IN PLASTIC CONTAINER	CALCIUM CHLORIDE; POTASSIUM CHLORIDE; SODIUM CHLORIDE; SODIUM LACTATE
DEXTROSE 5% IN SODIUM CHLORIDE 0.45% IN PLASTIC CONTAINER	DEXTROSE; SODIUM CHLORIDE
DEXTROSE 5% IN SODIUM CHLORIDE 0.33% IN PLASTIC CONTAINER	DEXTROSE; SODIUM CHLORIDE
DEXTROSE 5% IN SODIUM CHLORIDE 0.2% IN PLASTIC CONTAINER	DEXTROSE; SODIUM CHLORIDE
RINGER'S IN PLASTIC CONTAINER	CALCIUM CHLORIDE; POTASSIUM CHLORIDE; SODIUM CHLORIDE
DEXTROSE 5% IN RINGER'S IN PLASTIC CONTAINER	CALCIUM CHLORIDE; DEXTROSE; POTASSIUM CHLORIDE; SODIUM CHLORIDE
DEXTROSE 10% AND SODIUM CHLORIDE 0.9% IN PLASTIC CONTAINER	DEXTROSE; SODIUM CHLORIDE
DEXTROSE 2.5% AND SODIUM CHLORIDE 0.45% IN PLASTIC CONTAINER	DEXTROSE; SODIUM CHLORIDE
OVULEN-28	ETHYNODIOL DIACETATE; MESTRANOL
ORTHO-NOVUM 1/50 28	MESTRANOL; NORETHINDRONE
ORTHO-NOVUM 1/80 21	MESTRANOL; NORETHINDRONE
ORTHO-NOVUM 1/80 28	MESTRANOL; NORETHINDRONE
NORLESTRIN 28 1/50	ETHINYL ESTRADIOL; NORETHINDRONE ACETATE
NORINYL 1+80 21-DAY	MESTRANOL; NORETHINDRONE
NORINYL 1+80 28-DAY	MESTRANOL; NORETHINDRONE
NORLESTRIN 21 1/50	ETHINYL ESTRADIOL; NORETHINDRONE ACETATE
NORLESTRIN FE 1/50	ETHINYL ESTRADIOL; FERROUS FUMARATE; NORETHINDRONE ACETATE
VASCORAY	IOTHALAMATE MEGLUMINE; IOTHALAMATE SODIUM
OVRAL-28	ETHINYL ESTRADIOL; NORGESTREL
THYROLAR-0.25	LIOTRIX (T4;T3)
THYROLAR-2	LIOTRIX (T4;T3)
THYROLAR-3	LIOTRIX (T4;T3)
THYROLAR-1	LIOTRIX (T4;T3)
THYROLAR-0.5	LIOTRIX (T4;T3)
THYROLAR-5	LIOTRIX (T4;T3)
FREAMINE III 3% W/ ELECTROLYTES	AMINO ACIDS; MAGNESIUM ACETATE; PHOSPHORIC ACID; POTASSIUM CHLORIDE; SODIUM ACETATE; SODIUM CHLORIDE
FREAMINE III 8.5% W/ ELECTROLYTES	AMINO ACIDS; MAGNESIUM ACETATE; PHOSPHORIC ACID; POTASSIUM ACETATE; POTASSIUM CHLORIDE; SODIUM ACETATE
DARVON-N W/ ASA	ASPIRIN; PROPOXYPHENE NAPSYLATE
DARVOCET	ACETAMINOPHEN; PROPOXYPHENE HYDROCHLORIDE
ISOPAQUE 440	CALCIUM METRIZOATE; MEGLUMINE METRIZOATE; METRIZOATE MAGNESIUM; METRIZOATE SODIUM
NORLESTRIN 21 2.5/50	ETHINYL ESTRADIOL; NORETHINDRONE ACETATE
NORLESTRIN FE 2.5/50	ETHINYL ESTRADIOL; FERROUS FUMARATE; NORETHINDRONE ACETATE
TALWIN COMPOUND	ASPIRIN; PENTAZOCINE HYDROCHLORIDE
DEMULEN 1/50-21	ETHINYL ESTRADIOL; ETHYNODIOL DIACETATE
DEMULEN 1/50-28	ETHINYL ESTRADIOL; ETHYNODIOL DIACETATE
LIMBITROL	AMITRIPTYLINE HYDROCHLORIDE; CHLORDIAZEPOXIDE
LIMBITROL DS	AMITRIPTYLINE HYDROCHLORIDE; CHLORDIAZEPOXIDE
MARCAINE HYDROCHLORIDE W/ EPINEPHRINE	BUPIVACAINE HYDROCHLORIDE; EPINEPHRINE BITARTRATE
MARCAINE HYDROCHLORIDE W/ EPINEPHRINE PRESERVATIVE FREE	BUPIVACAINE HYDROCHLORIDE; EPINEPHRINE BITARTRATE
DARVOCET-N 50	ACETAMINOPHEN; PROPOXYPHENE NAPSYLATE
DARVOCET-N 100	ACETAMINOPHEN; PROPOXYPHENE NAPSYLATE
LOESTRIN FE 1/20	ETHINYL ESTRADIOL; NORETHINDRONE ACETATE
LOESTRIN FE 1.5/30	ETHINYL ESTRADIOL; NORETHINDRONE ACETATE
MUCOMYST W/ ISOPROTERENOL	ACETYLCYSTEINE; ISOPROTERENOL HYDROCHLORIDE
SEPTRA	SULFAMETHOXAZOLE; TRIMETHOPRIM
SEPTRA DS	SULFAMETHOXAZOLE; TRIMETHOPRIM
BACTRIM	SULFAMETHOXAZOLE; TRIMETHOPRIM
BACTRIM DS	SULFAMETHOXAZOLE; TRIMETHOPRIM
PLASMA-LYTE 148 IN WATER IN PLASTIC CONTAINER	MAGNESIUM CHLORIDE; POTASSIUM CHLORIDE; SODIUM ACETATE; SODIUM CHLORIDE; SODIUM GLUCONATE
PLASMA-LYTE A IN PLASTIC CONTAINER	MAGNESIUM CHLORIDE; POTASSIUM CHLORIDE; SODIUM ACETATE; SODIUM CHLORIDE; SODIUM GLUCONATE
PLASMA-LYTE 56 AND DEXTROSE 5% IN PLASTIC CONTAINER	DEXTROSE; MAGNESIUM ACETATE TETRAHYDRATE; POTASSIUM ACETATE; SODIUM CHLORIDE
PLASMA-LYTE M AND DEXTROSE 5% IN PLASTIC CONTAINER	CALCIUM CHLORIDE; DEXTROSE; MAGNESIUM CHLORIDE; POTASSIUM CHLORIDE; SODIUM ACETATE; SODIUM CHLORIDE; SODIUM LACTATE
DICOPAC KIT	CYANOCOBALAMIN; CYANOCOBALAMIN CO-57; CYANOCOBALAMIN CO-58
PLASMA-LYTE R IN PLASTIC CONTAINER	CALCIUM CHLORIDE; MAGNESIUM CHLORIDE; POTASSIUM CHLORIDE; SODIUM ACETATE; SODIUM CHLORIDE; SODIUM LACTATE
PLASMA-LYTE 148 AND DEXTROSE 5% IN PLASTIC CONTAINER	DEXTROSE; MAGNESIUM CHLORIDE; POTASSIUM CHLORIDE; SODIUM ACETATE; SODIUM CHLORIDE; SODIUM GLUCONATE
DEXTROSE 5% AND ELECTROLYTE NO. 48 IN PLASTIC CONTAINER	DEXTROSE; MAGNESIUM CHLORIDE; POTASSIUM CHLORIDE; POTASSIUM PHOSPHATE, MONOBASIC; SODIUM CHLORIDE; SODIUM LACTATE
MODICON 21	ETHINYL ESTRADIOL; NORETHINDRONE
ORTHO-NOVUM 1/35-21	ETHINYL ESTRADIOL; NORETHINDRONE
TRAVASOL 5.5% W/ ELECTROLYTES	AMINO ACIDS; MAGNESIUM CHLORIDE; POTASSIUM PHOSPHATE, DIBASIC; SODIUM ACETATE; SODIUM CHLORIDE
TRAVASOL 8.5% W/ ELECTROLYTES	AMINO ACIDS; MAGNESIUM CHLORIDE; POTASSIUM PHOSPHATE, DIBASIC; SODIUM ACETATE; SODIUM CHLORIDE
TRAVASOL 3.5% W/ ELECTROLYTES	AMINO ACIDS; MAGNESIUM CHLORIDE; POTASSIUM PHOSPHATE, DIBASIC; SODIUM ACETATE; SODIUM CHLORIDE
COMBIPRES	CHLORTHALIDONE; CLONIDINE HYDROCHLORIDE
ISOPAQUE 280	CALCIUM; MEGLUMINE; METRIZOIC ACID
DEXTROSE 5% IN LACTATED RINGER'S IN PLASTIC CONTAINER	CALCIUM CHLORIDE; DEXTROSE; POTASSIUM CHLORIDE; SODIUM CHLORIDE; SODIUM LACTATE
DIANEAL 137 W/ DEXTROSE 1.5% IN PLASTIC CONTAINER	CALCIUM CHLORIDE; DEXTROSE; MAGNESIUM CHLORIDE; SODIUM CHLORIDE; SODIUM LACTATE
DIANEAL 137 W/ DEXTROSE 4.25% IN PLASTIC CONTAINER	CALCIUM CHLORIDE; DEXTROSE; MAGNESIUM CHLORIDE; SODIUM CHLORIDE; SODIUM LACTATE
DIANEAL 137 W/ DEXTROSE 2.5% IN PLASTIC CONTAINER	CALCIUM CHLORIDE; DEXTROSE; MAGNESIUM CHLORIDE; SODIUM CHLORIDE; SODIUM LACTATE
DIANEAL PD-2 W/ DEXTROSE 1.5% IN PLASTIC CONTAINER	CALCIUM CHLORIDE; DEXTROSE; MAGNESIUM CHLORIDE; SODIUM CHLORIDE; SODIUM LACTATE
DIANEAL PD-2 W/ DEXTROSE 2.5% IN PLASTIC CONTAINER	CALCIUM CHLORIDE; DEXTROSE; MAGNESIUM CHLORIDE; SODIUM CHLORIDE; SODIUM LACTATE
DIANEAL PD-2 W/ DEXTROSE 4.25% IN PLASTIC CONTAINER	CALCIUM CHLORIDE; DEXTROSE; MAGNESIUM CHLORIDE; SODIUM CHLORIDE; SODIUM LACTATE
DIANEAL PD-1 W/ DEXTROSE 1.5% IN PLASTIC CONTAINER	CALCIUM CHLORIDE; DEXTROSE; MAGNESIUM CHLORIDE; SODIUM CHLORIDE; SODIUM LACTATE
DIANEAL PD-1 W/ DEXTROSE 2.5% IN PLASTIC CONTAINER	CALCIUM CHLORIDE; DEXTROSE; MAGNESIUM CHLORIDE; SODIUM CHLORIDE; SODIUM LACTATE
DIANEAL PD-1 W/ DEXTROSE 4.25% IN PLASTIC CONTAINER	CALCIUM CHLORIDE; DEXTROSE; MAGNESIUM CHLORIDE; SODIUM CHLORIDE; SODIUM LACTATE
DIANEAL PD-1 W/ DEXTROSE 3.5% IN PLASTIC CONTAINER	CALCIUM CHLORIDE; DEXTROSE; MAGNESIUM CHLORIDE; SODIUM CHLORIDE; SODIUM LACTATE
DIANEAL PD-2 W/ DEXTROSE 3.5% IN PLASTIC CONTAINER	CALCIUM CHLORIDE; DEXTROSE; MAGNESIUM CHLORIDE; SODIUM CHLORIDE; SODIUM LACTATE
FIORINAL	ASPIRIN; BUTALBITAL; CAFFEINE
SINEMET	CARBIDOPA; LEVODOPA
BACTRIM PEDIATRIC	SULFAMETHOXAZOLE; TRIMETHOPRIM
NORINYL 1+35 21-DAY	ETHINYL ESTRADIOL; NORETHINDRONE
NORINYL 1+35 28-DAY	ETHINYL ESTRADIOL; NORETHINDRONE
BREVICON 21-DAY	ETHINYL ESTRADIOL; NORETHINDRONE
OVCON-50	ETHINYL ESTRADIOL; NORETHINDRONE
DEXTROSE 5% AND SODIUM CHLORIDE 0.9% IN PLASTIC CONTAINER	DEXTROSE; SODIUM CHLORIDE
NORMOSOL-R IN PLASTIC CONTAINER	MAGNESIUM CHLORIDE; POTASSIUM CHLORIDE; SODIUM ACETATE; SODIUM CHLORIDE; SODIUM GLUCONATE
SEPTRA GRAPE	SULFAMETHOXAZOLE; TRIMETHOPRIM
DEXTROSE 5% AND SODIUM CHLORIDE 0.225% IN PLASTIC CONTAINER	DEXTROSE; SODIUM CHLORIDE
DEXTROSE 5% AND SODIUM CHLORIDE 0.45% IN PLASTIC CONTAINER	DEXTROSE; SODIUM CHLORIDE
DEXTROSE 5% AND LACTATED RINGER'S IN PLASTIC CONTAINER	CALCIUM CHLORIDE; DEXTROSE; POTASSIUM CHLORIDE; SODIUM CHLORIDE; SODIUM LACTATE
NORMOSOL-R AND DEXTROSE 5% IN PLASTIC CONTAINER	DEXTROSE; MAGNESIUM CHLORIDE; POTASSIUM CHLORIDE; SODIUM ACETATE; SODIUM CHLORIDE; SODIUM GLUCONATE
NORMOSOL-M AND DEXTROSE 5% IN PLASTIC CONTAINER	DEXTROSE; MAGNESIUM ACETATE; POTASSIUM ACETATE; SODIUM CHLORIDE
LO/OVRAL	ETHINYL ESTRADIOL; NORGESTREL
DEXTROSE 5% AND POTASSIUM CHLORIDE 0.15% IN PLASTIC CONTAINER	DEXTROSE; POTASSIUM CHLORIDE
DEXTROSE 5% AND POTASSIUM CHLORIDE 0.3% IN PLASTIC CONTAINER	DEXTROSE; POTASSIUM CHLORIDE
DEXTROSE 5% AND POTASSIUM CHLORIDE 0.224% IN PLASTIC CONTAINER	DEXTROSE; POTASSIUM CHLORIDE
DEXTROSE 5% AND POTASSIUM CHLORIDE 0.075% IN PLASTIC CONTAINER	DEXTROSE; POTASSIUM CHLORIDE
SORBITOL-MANNITOL IN PLASTIC CONTAINER	MANNITOL; SORBITOL
PHYSIOSOL IN PLASTIC CONTAINER	MAGNESIUM CHLORIDE; POTASSIUM CHLORIDE; SODIUM ACETATE; SODIUM CHLORIDE; SODIUM GLUCONATE
PERGONAL	MENOTROPINS (FSH;LH)
POTASSIUM CHLORIDE 0.15% IN SODIUM CHLORIDE 0.9% IN PLASTIC CONTAINER	POTASSIUM CHLORIDE; SODIUM CHLORIDE
POTASSIUM CHLORIDE 0.3% AND SODIUM CHLORIDE 0.9% IN PLASTIC CONTAINER	POTASSIUM CHLORIDE; SODIUM CHLORIDE
POTASSIUM CHLORIDE 0.224% IN SODIUM CHLORIDE 0.9%	POTASSIUM CHLORIDE; SODIUM CHLORIDE
SODIUM CHLORIDE 0.9% AND POTASSIUM CHLORIDE 0.075% IN PLASTIC CONTAINER	POTASSIUM CHLORIDE; SODIUM CHLORIDE
POTASSIUM CHLORIDE 0.15% IN SODIUM CHLORIDE 0.45% IN PLASTIC CONTAINER	POTASSIUM CHLORIDE; SODIUM CHLORIDE
AMINOSYN 8.5% W/ ELECTROLYTES	AMINO ACIDS; MAGNESIUM CHLORIDE; POTASSIUM PHOSPHATE, DIBASIC; SODIUM CHLORIDE
AMINOSYN 8.5% W/ELECTROLYTES	AMINO ACIDS; MAGNESIUM CHLORIDE; POTASSIUM CHLORIDE; SODIUM CHLORIDE; SODIUM PHOSPHATE, DIBASIC
OVCON-35	ETHINYL ESTRADIOL; NORETHINDRONE
MODICON 28	ETHINYL ESTRADIOL; NORETHINDRONE
BREVICON 28-DAY	ETHINYL ESTRADIOL; NORETHINDRONE
MOTOFEN HALF-STRENGTH	ATROPINE SULFATE; DIFENOXIN HYDROCHLORIDE
MOTOFEN	ATROPINE SULFATE; DIFENOXIN HYDROCHLORIDE
DURANEST	EPINEPHRINE BITARTRATE; ETIDOCAINE HYDROCHLORIDE
AMINOSYN 7% W/ ELECTROLYTES	AMINO ACIDS; MAGNESIUM CHLORIDE; POTASSIUM PHOSPHATE, DIBASIC; SODIUM CHLORIDE
AMINOSYN 3.5% M	AMINO ACIDS; MAGNESIUM ACETATE; POTASSIUM ACETATE; SODIUM CHLORIDE
DEXTROSE 5% AND SODIUM CHLORIDE 0.3% IN PLASTIC CONTAINER	DEXTROSE; SODIUM CHLORIDE
LO/OVRAL-28	ETHINYL ESTRADIOL; NORGESTREL
LOESTRIN 21 1.5/30	ETHINYL ESTRADIOL; NORETHINDRONE ACETATE
LOESTRIN 21 1/20	ETHINYL ESTRADIOL; NORETHINDRONE ACETATE
TRIDESILON	ACETIC ACID, GLACIAL; DESONIDE
ORTHO-NOVUM 1/35-28	ETHINYL ESTRADIOL; NORETHINDRONE
NORMINEST FE	ETHINYL ESTRADIOL;NORETHINDRONE; FERROUS FUMARATE
VEINAMINE 8%	AMINO ACIDS; MAGNESIUM CHLORIDE; POTASSIUM ACETATE; POTASSIUM CHLORIDE; SODIUM ACETATE
DEPO-TESTADIOL	ESTRADIOL CYPIONATE; TESTOSTERONE CYPIONATE
MINIZIDE	POLYTHIAZIDE; PRAZOSIN HYDROCHLORIDE
DEXTROSE 5%, SODIUM CHLORIDE 0.45% AND POTASSIUM CHLORIDE 20MEQ (K) IN PLASTIC CONTAINER	DEXTROSE; POTASSIUM CHLORIDE; SODIUM CHLORIDE
DEXTROSE 5%, SODIUM CHLORIDE 0.45% AND POTASSIUM CHLORIDE 5MEQ IN PLASTIC CONTAINER	DEXTROSE; POTASSIUM CHLORIDE; SODIUM CHLORIDE
DEXTROSE 5%, SODIUM CHLORIDE 0.45% AND POTASSIUM CHLORIDE 15MEQ IN PLASTIC CONTAINER	DEXTROSE; POTASSIUM CHLORIDE; SODIUM CHLORIDE
POTASSIUM CHLORIDE 5MEQ IN DEXTROSE 5% AND SODIUM CHLORIDE 0.45% IN PLASTIC CONTAINER	DEXTROSE; POTASSIUM CHLORIDE; SODIUM CHLORIDE
POTASSIUM CHLORIDE 10MEQ IN DEXTROSE 5% AND SODIUM CHLORIDE 0.45% IN PLASTIC CONTAINER	DEXTROSE; POTASSIUM CHLORIDE; SODIUM CHLORIDE
POTASSIUM CHLORIDE 20MEQ IN DEXTROSE 5% AND SODIUM CHLORIDE 0.45% IN PLASTIC CONTAINER	DEXTROSE; POTASSIUM CHLORIDE; SODIUM CHLORIDE
POTASSIUM CHLORIDE 30MEQ IN DEXTROSE 5% AND SODIUM CHLORIDE 0.45% IN PLASTIC CONTAINER	DEXTROSE; POTASSIUM CHLORIDE; SODIUM CHLORIDE
POTASSIUM CHLORIDE 40MEQ IN DEXTROSE 5% AND SODIUM CHLORIDE 0.45% IN PLASTIC CONTAINER	DEXTROSE; POTASSIUM CHLORIDE; SODIUM CHLORIDE
DEXTROSE 5% AND SODIUM CHLORIDE 0.33% IN PLASTIC CONTAINER	DEXTROSE; SODIUM CHLORIDE
DEXTROSE 5% AND SODIUM CHLORIDE 0.2% IN PLASTIC CONTAINER	DEXTROSE; SODIUM CHLORIDE
DEXTROSE 5% AND SODIUM CHLORIDE 0.11% IN PLASTIC CONTAINER	DEXTROSE; SODIUM CHLORIDE
INDERIDE-40/25	HYDROCHLOROTHIAZIDE; PROPRANOLOL HYDROCHLORIDE
INDERIDE-80/25	HYDROCHLOROTHIAZIDE; PROPRANOLOL HYDROCHLORIDE
DEXTROSE 5%, SODIUM CHLORIDE 0.2% AND POTASSIUM CHLORIDE 20MEQ (K)	DEXTROSE; POTASSIUM CHLORIDE; SODIUM CHLORIDE
DEXTROSE 5%, SODIUM CHLORIDE 0.2% AND POTASSIUM CHLORIDE 5MEQ	DEXTROSE; POTASSIUM CHLORIDE; SODIUM CHLORIDE
DEXTROSE 5%, SODIUM CHLORIDE 0.2% AND POTASSIUM CHLORIDE 5MEQ (K)	DEXTROSE; POTASSIUM CHLORIDE; SODIUM CHLORIDE
DEXTROSE 5%, SODIUM CHLORIDE 0.2% AND POTASSIUM CHLORIDE 15MEQ (K)	DEXTROSE; POTASSIUM CHLORIDE; SODIUM CHLORIDE
DEXTROSE 5%, SODIUM CHLORIDE 0.2% AND POTASSIUM CHLORIDE 30MEQ	DEXTROSE; POTASSIUM CHLORIDE; SODIUM CHLORIDE
DEXTROSE 5%, SODIUM CHLORIDE 0.2% AND POTASSIUM CHLORIDE 10MEQ	DEXTROSE; POTASSIUM CHLORIDE; SODIUM CHLORIDE
DEXTROSE 5%, SODIUM CHLORIDE 0.2% AND POTASSIUM CHLORIDE 20MEQ	DEXTROSE; POTASSIUM CHLORIDE; SODIUM CHLORIDE
DEXTROSE 5%, SODIUM CHLORIDE 0.2% AND POTASSIUM CHLORIDE 40MEQ	DEXTROSE; POTASSIUM CHLORIDE; SODIUM CHLORIDE
CORSYM	CHLORPHENIRAMINE POLISTIREX; PHENYLPROPANOLAMINE POLISTIREX
DEXTROSE 3.3% AND SODIUM CHLORIDE 0.3% IN PLASTIC CONTAINER	DEXTROSE; SODIUM CHLORIDE
TIMOLIDE 10-25	HYDROCHLOROTHIAZIDE; TIMOLOL MALEATE
TRIAMINIC-12	CHLORPHENIRAMINE MALEATE; PHENYLPROPANOLAMINE HYDROCHLORIDE
DEMULEN 1/35-28	ETHINYL ESTRADIOL; ETHYNODIOL DIACETATE
DEMULEN 1/35-21	ETHINYL ESTRADIOL; ETHYNODIOL DIACETATE
INSULIN NORDISK MIXTARD (PORK)	INSULIN PURIFIED PORK; INSULIN SUSP ISOPHANE PURIFIED PORK
MODURETIC 5-50	AMILORIDE HYDROCHLORIDE; HYDROCHLOROTHIAZIDE
LO/OVRAL FE	ETHINYL ESTRADIOL; LEVONORGESTREL; FERROUS FUMARATE
DEXTROSE 10% AND SODIUM CHLORIDE 0.45% IN PLASTIC CONTAINER	DEXTROSE; SODIUM CHLORIDE
SULFAMETHOXAZOLE AND TRIMETHOPRIM	SULFAMETHOXAZOLE; TRIMETHOPRIM
ISOLYTE S IN PLASTIC CONTAINER	MAGNESIUM CHLORIDE; POTASSIUM CHLORIDE; SODIUM ACETATE; SODIUM CHLORIDE; SODIUM GLUCONATE
DEXTROSE 5% AND RINGER'S IN PLASTIC CONTAINER	CALCIUM CHLORIDE; DEXTROSE; POTASSIUM CHLORIDE; SODIUM CHLORIDE
DEXTROSE 5% IN ACETATED RINGER'S IN PLASTIC CONTAINER	CALCIUM CHLORIDE; DEXTROSE; POTASSIUM CHLORIDE; SODIUM ACETATE; SODIUM CHLORIDE
DEXTROSE 5%, SODIUM CHLORIDE 0.45% AND POTASSIUM CHLORIDE 0.15% IN PLASTIC CONTAINER	DEXTROSE; POTASSIUM CHLORIDE; SODIUM CHLORIDE
DEXTROSE 5%, SODIUM CHLORIDE 0.45% AND POTASSIUM CHLORIDE 0.22% IN PLASTIC CONTAINER	DEXTROSE; POTASSIUM CHLORIDE; SODIUM CHLORIDE
DEXTROSE 5%, SODIUM CHLORIDE 0.45% AND POTASSIUM CHLORIDE 0.3% IN PLASTIC CONTAINER	DEXTROSE; POTASSIUM CHLORIDE; SODIUM CHLORIDE
DEXTROSE 5%, SODIUM CHLORIDE 0.2% AND POTASSIUM CHLORIDE 0.15% IN PLASTIC CONTAINER	DEXTROSE; POTASSIUM CHLORIDE; SODIUM CHLORIDE
DEXTROSE 5%, SODIUM CHLORIDE 0.2% AND POTASSIUM CHLORIDE 0.224% IN PLASTIC CONTAINER	DEXTROSE; POTASSIUM CHLORIDE; SODIUM CHLORIDE
DEXTROSE 5%, SODIUM CHLORIDE 0.2% AND POTASSIUM CHLORIDE 0.3% IN PLASTIC CONTAINER	DEXTROSE; POTASSIUM CHLORIDE; SODIUM CHLORIDE
DEXTROSE 5%, SODIUM CHLORIDE 0.2% AND POTASSIUM CHLORIDE 0.075%	DEXTROSE; POTASSIUM CHLORIDE; SODIUM CHLORIDE
DEXTROSE 5%, SODIUM CHLORIDE 0.45% AND POTASSIUM CHLORIDE 0.075%	DEXTROSE; POTASSIUM CHLORIDE; SODIUM CHLORIDE
DEXTROSE 5%, SODIUM CHLORIDE 0.33% AND POTASSIUM CHLORIDE 0.075% IN PLASTIC CONTAINER	DEXTROSE; POTASSIUM CHLORIDE; SODIUM CHLORIDE
DEXTROSE 5%, SODIUM CHLORIDE 0.33% AND POTASSIUM CHLORIDE 0.15% IN PLASTIC CONTAINER	DEXTROSE; POTASSIUM CHLORIDE; SODIUM CHLORIDE
DEXTROSE 5%, SODIUM CHLORIDE 0.33% AND POTASSIUM CHLORIDE 0.22% IN PLASTIC CONTAINER	DEXTROSE; POTASSIUM CHLORIDE; SODIUM CHLORIDE
DEXTROSE 5%, SODIUM CHLORIDE 0.33% AND POTASSIUM CHLORIDE 0.30% IN PLASTIC CONTAINER	DEXTROSE; POTASSIUM CHLORIDE; SODIUM CHLORIDE
ISOLYTE E W/ DEXTROSE 5% IN PLASTIC CONTAINER	CALCIUM CHLORIDE; DEXTROSE; MAGNESIUM CHLORIDE; POTASSIUM CHLORIDE; SODIUM ACETATE; SODIUM CHLORIDE; SODIUM CITRATE
ISOLYTE M W/ DEXTROSE 5% IN PLASTIC CONTAINER	DEXTROSE; POTASSIUM CHLORIDE; POTASSIUM PHOSPHATE, DIBASIC; SODIUM ACETATE; SODIUM CHLORIDE
ISOLYTE R W/ DEXTROSE 5% IN PLASTIC CONTAINER	CALCIUM CHLORIDE; DEXTROSE; MAGNESIUM CHLORIDE; POTASSIUM CHLORIDE; SODIUM ACETATE; SODIUM CHLORIDE
ISOLYTE H W/ DEXTROSE 5% IN PLASTIC CONTAINER	DEXTROSE; MAGNESIUM CHLORIDE; POTASSIUM CHLORIDE; SODIUM ACETATE; SODIUM CHLORIDE
ISOLYTE S W/ DEXTROSE 5% IN PLASTIC CONTAINER	DEXTROSE; MAGNESIUM CHLORIDE; POTASSIUM CHLORIDE; SODIUM ACETATE; SODIUM CHLORIDE; SODIUM GLUCONATE
LOPRESSOR HCT	HYDROCHLOROTHIAZIDE; METOPROLOL TARTRATE
SENSORCAINE	BUPIVACAINE HYDROCHLORIDE; EPINEPHRINE BITARTRATE
TIS-U-SOL IN PLASTIC CONTAINER	MAGNESIUM SULFATE; POTASSIUM CHLORIDE; POTASSIUM PHOSPHATE, MONOBASIC; SODIUM CHLORIDE; SODIUM PHOSPHATE
ORTHO-NOVUM 10/11-21	ETHINYL ESTRADIOL; NORETHINDRONE
ORTHO-NOVUM 10/11-28	ETHINYL ESTRADIOL; NORETHINDRONE
POTASSIUM CHLORIDE 15MEQ IN DEXTROSE 5% AND SODIUM CHLORIDE 0.45% IN PLASTIC CONTAINER	DEXTROSE; POTASSIUM CHLORIDE; SODIUM CHLORIDE
POTASSIUM CHLORIDE 20MEQ IN DEXTROSE 5% AND SODIUM CHLORIDE 0.225% IN PLASTIC CONTAINER	DEXTROSE; POTASSIUM CHLORIDE; SODIUM CHLORIDE
POTASSIUM CHLORIDE 10MEQ IN DEXTROSE 5% AND SODIUM CHLORIDE 0.225% IN PLASTIC CONTAINER	DEXTROSE; POTASSIUM CHLORIDE; SODIUM CHLORIDE
POTASSIUM CHLORIDE 30MEQ IN DEXTROSE 5% AND SODIUM CHLORIDE 0.225% IN PLASTIC CONTAINER	DEXTROSE; POTASSIUM CHLORIDE; SODIUM CHLORIDE
POTASSIUM CHLORIDE 40MEQ IN DEXTROSE 5% AND SODIUM CHLORIDE 0.225% IN PLASTIC CONTAINER	DEXTROSE; POTASSIUM CHLORIDE; SODIUM CHLORIDE
POTASSIUM CHLORIDE 5MEQ IN DEXTROSE 5% AND SODIUM CHLORIDE 0.225% IN PLASTIC CONTAINER	DEXTROSE; POTASSIUM CHLORIDE; SODIUM CHLORIDE
POTASSIUM CHLORIDE 15MEQ IN DEXTROSE 5% AND SODIUM CHLORIDE 0.225% IN PLASTIC CONTAINER	DEXTROSE; POTASSIUM CHLORIDE; SODIUM CHLORIDE
POTASSIUM CHLORIDE 20MEQ IN DEXTROSE 5% IN PLASTIC CONTAINER	DEXTROSE; POTASSIUM CHLORIDE
POTASSIUM CHLORIDE 40MEQ IN DEXTROSE 5% IN PLASTIC CONTAINER	DEXTROSE; POTASSIUM CHLORIDE
POTASSIUM CHLORIDE 30MEQ IN DEXTROSE 5% IN PLASTIC CONTAINER	DEXTROSE; POTASSIUM CHLORIDE
DEXTROSE 2.5% AND SODIUM CHLORIDE 0.9% IN PLASTIC CONTAINER	DEXTROSE; SODIUM CHLORIDE
DELFLEX W/ DEXTROSE 4.25% IN PLASTIC CONTAINER	CALCIUM CHLORIDE; DEXTROSE; MAGNESIUM CHLORIDE; SODIUM CHLORIDE; SODIUM LACTATE
DELFLEX W/ DEXTROSE 1.5% IN PLASTIC CONTAINER	CALCIUM CHLORIDE; DEXTROSE; MAGNESIUM CHLORIDE; SODIUM CHLORIDE; SODIUM LACTATE
DELFLEX W/ DEXTROSE 2.5% IN PLASTIC CONTAINER	CALCIUM CHLORIDE; DEXTROSE; MAGNESIUM CHLORIDE; SODIUM CHLORIDE; SODIUM LACTATE
DELFLEX-LM W/ DEXTROSE 1.5% IN PLASTIC CONTAINER	CALCIUM CHLORIDE; DEXTROSE; MAGNESIUM CHLORIDE; SODIUM CHLORIDE; SODIUM LACTATE
DELFLEX-LM W/ DEXTROSE 2.5% IN PLASTIC CONTAINER	CALCIUM CHLORIDE; DEXTROSE; MAGNESIUM CHLORIDE; SODIUM CHLORIDE; SODIUM LACTATE
DELFLEX-LM W/ DEXTROSE 4.25% IN PLASTIC CONTAINER	CALCIUM CHLORIDE; DEXTROSE; MAGNESIUM CHLORIDE; SODIUM CHLORIDE; SODIUM LACTATE
DELFLEX W/ DEXTROSE 3.5% IN PLASTIC CONTAINER	CALCIUM CHLORIDE; DEXTROSE; MAGNESIUM CHLORIDE; SODIUM CHLORIDE; SODIUM LACTATE
DELFLEX-LM W/ DEXTROSE 3.5% IN PLASTIC CONTAINER	CALCIUM CHLORIDE; DEXTROSE; MAGNESIUM CHLORIDE; SODIUM CHLORIDE; SODIUM LACTATE
DEXTROSE 10% AND SODIUM CHLORIDE 0.2% IN PLASTIC CONTAINER	DEXTROSE; SODIUM CHLORIDE
CHLOR-TRIMETON	CHLORPHENIRAMINE MALEATE; PSEUDOEPHEDRINE SULFATE
PHYSIOSOL PH 7.4 IN PLASTIC CONTAINER	MAGNESIUM CHLORIDE; POTASSIUM CHLORIDE; SODIUM ACETATE; SODIUM CHLORIDE; SODIUM GLUCONATE
MVC PLUS	ASCORBIC ACID; BIOTIN; CYANOCOBALAMIN; DEXPANTHENOL; ERGOCALCIFEROL; FOLIC ACID; NIACINAMIDE; PYRIDOXINE HYDROCHLORIDE; RIBOFLAVIN 5'-PHOSPHATE SODIUM; THIAMINE HYDROCHLORIDE; VITAMIN A; VITAMIN E
M.V.C. 9+3	ASCORBIC ACID; BIOTIN; CYANOCOBALAMIN; DEXPANTHENOL; ERGOCALCIFEROL; FOLIC ACID; NIACINAMIDE; PYRIDOXINE HYDROCHLORIDE; RIBOFLAVIN 5'-PHOSPHATE SODIUM; THIAMINE HYDROCHLORIDE; VITAMIN A; VITAMIN E
TALACEN	ACETAMINOPHEN; PENTAZOCINE HYDROCHLORIDE
DIALYTE W/ DEXTROSE 1.5% IN PLASTIC CONTAINER	CALCIUM CHLORIDE; DEXTROSE; MAGNESIUM CHLORIDE; SODIUM ACETATE; SODIUM CHLORIDE
DIALYTE LM/ DEXTROSE 1.5% IN PLASTIC CONTAINER	CALCIUM CHLORIDE; DEXTROSE; MAGNESIUM CHLORIDE; SODIUM CHLORIDE; SODIUM LACTATE
DIALYTE W/ DEXTROSE 4.25% IN PLASTIC CONTAINER	CALCIUM CHLORIDE; DEXTROSE; MAGNESIUM CHLORIDE; SODIUM ACETATE; SODIUM CHLORIDE
DIALYTE LM/ DEXTROSE 4.25% IN PLASTIC CONTAINER	CALCIUM CHLORIDE; DEXTROSE; MAGNESIUM CHLORIDE; SODIUM CHLORIDE; SODIUM LACTATE
DIALYTE LM/ DEXTROSE 2.5% IN PLASTIC CONTAINER	CALCIUM CHLORIDE; DEXTROSE; MAGNESIUM CHLORIDE; SODIUM CHLORIDE; SODIUM LACTATE
BSS PLUS	CALCIUM CHLORIDE; DEXTROSE; GLUTATHIONE DISULFIDE; MAGNESIUM CHLORIDE; POTASSIUM CHLORIDE; SODIUM BICARBONATE; SODIUM CHLORIDE; SODIUM PHOSPHATE
TRINALIN	AZATADINE MALEATE; PSEUDOEPHEDRINE SULFATE
TIS-U-SOL	MAGNESIUM SULFATE; POTASSIUM CHLORIDE; POTASSIUM PHOSPHATE, MONOBASIC; SODIUM CHLORIDE; SODIUM PHOSPHATE
BAROS	SODIUM BICARBONATE; TARTARIC ACID
IRRIGATING SOLUTION G IN PLASTIC CONTAINER	CITRIC ACID; MAGNESIUM OXIDE; SODIUM CARBONATE
FANSIDAR	PYRIMETHAMINE; SULFADOXINE
PROCALAMINE	AMINO ACIDS; CALCIUM ACETATE; GLYCERIN; MAGNESIUM ACETATE; PHOSPHORIC ACID; POTASSIUM CHLORIDE; SODIUM ACETATE; SODIUM CHLORIDE
SULFAMETHOXAZOLE AND TRIMETHOPRIM DOUBLE STRENGTH	SULFAMETHOXAZOLE; TRIMETHOPRIM
PLEGISOL IN PLASTIC CONTAINER	CALCIUM CHLORIDE; MAGNESIUM CHLORIDE; POTASSIUM CHLORIDE; SODIUM CHLORIDE
SULFATRIM PEDIATRIC	SULFAMETHOXAZOLE; TRIMETHOPRIM
SULFATRIM	SULFAMETHOXAZOLE; TRIMETHOPRIM
DEXTROSE 5%, SODIUM CHLORIDE 0.33% AND POTASSIUM CHLORIDE 5MEQ IN PLASTIC CONTAINER	DEXTROSE; POTASSIUM CHLORIDE; SODIUM CHLORIDE
DEXTROSE 5%, SODIUM CHLORIDE 0.33% AND POTASSIUM CHLORIDE 10MEQ IN PLASTIC CONTAINER	DEXTROSE; POTASSIUM CHLORIDE; SODIUM CHLORIDE
DEXTROSE 5%, SODIUM CHLORIDE 0.33% AND POTASSIUM CHLORIDE 15MEQ IN PLASTIC CONTAINER	DEXTROSE; POTASSIUM CHLORIDE; SODIUM CHLORIDE
DEXTROSE 5%, SODIUM CHLORIDE 0.33% AND POTASSIUM CHLORIDE 20MEQ IN PLASTIC CONTAINER	DEXTROSE; POTASSIUM CHLORIDE; SODIUM CHLORIDE
DEXTROSE 5%, SODIUM CHLORIDE 0.33% AND POTASSIUM CHLORIDE 30MEQ IN PLASTIC CONTAINER	DEXTROSE; POTASSIUM CHLORIDE; SODIUM CHLORIDE
DEXTROSE 5%, SODIUM CHLORIDE 0.33% AND POTASSIUM CHLORIDE 40MEQ IN PLASTIC CONTAINER	DEXTROSE; POTASSIUM CHLORIDE; SODIUM CHLORIDE
CORZIDE	BENDROFLUMETHIAZIDE; NADOLOL
NORDETTE-21	ETHINYL ESTRADIOL; LEVONORGESTREL
GAVISCON	ALUMINUM HYDROXIDE; MAGNESIUM TRISILICATE
CAPOZIDE 25/15	CAPTOPRIL; HYDROCHLOROTHIAZIDE
CAPOZIDE 25/25	CAPTOPRIL; HYDROCHLOROTHIAZIDE
CAPOZIDE 50/25	CAPTOPRIL; HYDROCHLOROTHIAZIDE
CAPOZIDE 50/15	CAPTOPRIL; HYDROCHLOROTHIAZIDE
SODIUM CHLORIDE 0.9% AND POTASSIUM CHLORIDE 0.15% IN PLASTIC CONTAINER	POTASSIUM CHLORIDE; SODIUM CHLORIDE
SODIUM CHLORIDE 0.9% AND POTASSIUM CHLORIDE 0.22% IN PLASTIC CONTAINER	POTASSIUM CHLORIDE; SODIUM CHLORIDE
SODIUM CHLORIDE 0.9% AND POTASSIUM CHLORIDE 0.3% IN PLASTIC CONTAINER	POTASSIUM CHLORIDE; SODIUM CHLORIDE
ACETATED RINGER'S IN PLASTIC CONTAINER	CALCIUM CHLORIDE; POTASSIUM CHLORIDE; SODIUM ACETATE; SODIUM CHLORIDE
TALWIN NX	NALOXONE HYDROCHLORIDE; PENTAZOCINE HYDROCHLORIDE
POTASSIUM CHLORIDE 0.075% IN DEXTROSE 5% IN PLASTIC CONTAINER	DEXTROSE; POTASSIUM CHLORIDE
POTASSIUM CHLORIDE 0.15% IN DEXTROSE 5% IN PLASTIC CONTAINER	DEXTROSE; POTASSIUM CHLORIDE
POTASSIUM CHLORIDE 0.22% IN DEXTROSE 5% IN PLASTIC CONTAINER	DEXTROSE; POTASSIUM CHLORIDE
POTASSIUM CHLORIDE 0.3% IN DEXTROSE 5% IN PLASTIC CONTAINER	DEXTROSE; POTASSIUM CHLORIDE
VASOCON-A	ANTAZOLINE PHOSPHATE; NAPHAZOLINE HYDROCHLORIDE
ISOCLOR	CHLORPHENIRAMINE MALEATE; PSEUDOEPHEDRINE HYDROCHLORIDE
TENORETIC 100	ATENOLOL; CHLORTHALIDONE
TENORETIC 50	ATENOLOL; CHLORTHALIDONE
NORDETTE-28	ETHINYL ESTRADIOL; LEVONORGESTREL
COLD CAPSULE IV	CHLORPHENIRAMINE MALEATE; PHENYLPROPANOLAMINE HYDROCHLORIDE
COLD CAPSULE V	CHLORPHENIRAMINE MALEATE; PHENYLPROPANOLAMINE HYDROCHLORIDE
AMINOSYN 3.5% M IN PLASTIC CONTAINER	AMINO ACIDS; MAGNESIUM ACETATE; PHOSPHORIC ACID; POTASSIUM ACETATE; SODIUM CHLORIDE
DIALYTE CONCENTRATE W/ DEXTROSE 30% IN PLASTIC CONTAINER	CALCIUM CHLORIDE; DEXTROSE; MAGNESIUM CHLORIDE; SODIUM ACETATE; SODIUM CHLORIDE
DIALYTE CONCENTRATE W/ DEXTROSE 50% IN PLASTIC CONTAINER	CALCIUM CHLORIDE; DEXTROSE; MAGNESIUM CHLORIDE; SODIUM ACETATE; SODIUM CHLORIDE
LOTRISONE	BETAMETHASONE DIPROPIONATE; CLOTRIMAZOLE
DEXTROSE 5% AND ELECTROLYTE NO. 75 IN PLASTIC CONTAINER	DEXTROSE; POTASSIUM CHLORIDE; POTASSIUM PHOSPHATE, MONOBASIC; SODIUM CHLORIDE; SODIUM LACTATE
PSEUDOEPHEDRINE HYDROCHLORIDE AND CHLORPHENIRAMINE MALEATE	CHLORPHENIRAMINE MALEATE; PSEUDOEPHEDRINE HYDROCHLORIDE
VISKAZIDE	HYDROCHLOROTHIAZIDE; PINDOLOL
POTASSIUM CHLORIDE 10MEQ IN DEXTROSE 5% AND SODIUM CHLORIDE 0.3% IN PLASTIC CONTAINER	DEXTROSE; POTASSIUM CHLORIDE; SODIUM CHLORIDE
POTASSIUM CHLORIDE 20MEQ IN DEXTROSE 5% IN SODIUM CHLORIDE 0.3% IN PLASTIC CONTAINER	DEXTROSE; POTASSIUM CHLORIDE; SODIUM CHLORIDE
POTASSIUM CHLORIDE 30MEQ IN DEXTROSE 5% AND SODIUM CHLORIDE 0.3% IN PLASTIC CONTAINER	DEXTROSE; POTASSIUM CHLORIDE; SODIUM CHLORIDE
POTASSIUM CHLORIDE 40MEQ IN DEXTROSE 5% AND SODIUM CHLORIDE 0.3% IN PLASTIC CONTAINER	DEXTROSE; POTASSIUM CHLORIDE; SODIUM CHLORIDE
POTASSIUM CHLORIDE 5MEQ IN DEXTROSE 5% AND SODIUM CHLORIDE 0.3% IN PLASTIC CONTAINER	DEXTROSE; POTASSIUM CHLORIDE; SODIUM CHLORIDE
POTASSIUM CHLORIDE 15MEQ IN DEXTROSE 5% AND SODIUM CHLORIDE 0.3% IN PLASTIC CONTAINER	DEXTROSE; POTASSIUM CHLORIDE; SODIUM CHLORIDE
POTASSIUM CHLORIDE 20MEQ IN DEXTROSE 5% AND SODIUM CHLORIDE 0.3% IN PLASTIC CONTAINER	DEXTROSE; POTASSIUM CHLORIDE; SODIUM CHLORIDE
DELFLEX W/ DEXTROSE 1.5% LOW MAGNESIUM IN PLASTIC CONTAINER	CALCIUM CHLORIDE; DEXTROSE; MAGNESIUM CHLORIDE; SODIUM CHLORIDE; SODIUM LACTATE
DELFLEX W/ DEXTROSE 2.5% LOW MAGNESIUM IN PLASTIC CONTAINER	CALCIUM CHLORIDE; DEXTROSE; MAGNESIUM CHLORIDE; SODIUM CHLORIDE; SODIUM LACTATE
DELFLEX W/ DEXTROSE 4.25% LOW MAGNESIUM IN PLASTIC CONTAINER	CALCIUM CHLORIDE; DEXTROSE; MAGNESIUM CHLORIDE; SODIUM CHLORIDE; SODIUM LACTATE
EMBOLEX	DIHYDROERGOTAMINE MESYLATE; HEPARIN SODIUM; LIDOCAINE HYDROCHLORIDE
SODIUM PHOSPHATES IN PLASTIC CONTAINER	SODIUM PHOSPHATE, DIBASIC, HEPTAHYDRATE; SODIUM PHOSPHATE, MONOBASIC, ANHYDROUS
TPN ELECTROLYTES IN PLASTIC CONTAINER	CALCIUM CHLORIDE; MAGNESIUM CHLORIDE; POTASSIUM CHLORIDE; SODIUM ACETATE; SODIUM CHLORIDE
ISOLYTE E IN PLASTIC CONTAINER	CALCIUM CHLORIDE; MAGNESIUM CHLORIDE; POTASSIUM CHLORIDE; SODIUM ACETATE; SODIUM CHLORIDE; SODIUM CITRATE
UROLOGIC G IN PLASTIC CONTAINER	CITRIC ACID; MAGNESIUM OXIDE; SODIUM CARBONATE
HEXABRIX	IOXAGLATE MEGLUMINE; IOXAGLATE SODIUM
M.V.I. PEDIATRIC	ASCORBIC ACID; BIOTIN; CYANOCOBALAMIN; DEXPANTHENOL; ERGOCALCIFEROL; FOLIC ACID; NIACINAMIDE; PHYTONADIONE; PYRIDOXINE HYDROCHLORIDE; RIBOFLAVIN 5'-PHOSPHATE SODIUM; THIAMINE HYDROCHLORIDE; VITAMIN A; VITAMIN E
NORQUEST FE	ETHINYL ESTRADIOL; FERROUS FUMARATE; NORETHINDRONE
PENNTUSS	CHLORPHENIRAMINE POLISTIREX; CODEINE POLISTIREX
M.V.I.-12 LYOPHILIZED	ASCORBIC ACID; BIOTIN; CYANOCOBALAMIN; DEXPANTHENOL; ERGOCALCIFEROL; FOLIC ACID; NIACINAMIDE; PYRIDOXINE; RIBOFLAVIN 5'-PHOSPHATE SODIUM; THIAMINE; VITAMIN A; VITAMIN E
CODIMAL-L.A. 12	CHLORPHENIRAMINE MALEATE; PSEUDOEPHEDRINE HYDROCHLORIDE
TRI-NORINYL 21-DAY	ETHINYL ESTRADIOL; NORETHINDRONE
TRI-NORINYL 28-DAY	ETHINYL ESTRADIOL; NORETHINDRONE
COLYTE	POLYETHYLENE GLYCOL 3350; POTASSIUM CHLORIDE; SODIUM BICARBONATE; SODIUM CHLORIDE; SODIUM SULFATE ANHYDROUS
COLYTE-FLAVORED	POLYETHYLENE GLYCOL 3350; POTASSIUM CHLORIDE; SODIUM BICARBONATE; SODIUM CHLORIDE; SODIUM SULFATE ANHYDROUS
COLYTE WITH FLAVOR PACKS	POLYETHYLENE GLYCOL 3350; POTASSIUM CHLORIDE; SODIUM BICARBONATE; SODIUM CHLORIDE; SODIUM SULFATE ANHYDROUS
ORTHO-NOVUM 7/7/7-21	ETHINYL ESTRADIOL; NORETHINDRONE
ORTHO-NOVUM 7/7/7-28	ETHINYL ESTRADIOL; NORETHINDRONE
VASOCIDIN	PREDNISOLONE ACETATE; SULFACETAMIDE SODIUM
LIPOSYN II 20%	SAFFLOWER OIL; SOYBEAN OIL
ACTIFED	PSEUDOEPHEDRINE HYDROCHLORIDE; TRIPROLIDINE HYDROCHLORIDE
LIPOSYN II 10%	SAFFLOWER OIL; SOYBEAN OIL
ORTHO-NOVUM 7/14-21	ETHINYL ESTRADIOL; NORETHINDRONE
ORTHO-NOVUM 7/14-28	ETHINYL ESTRADIOL; NORETHINDRONE
ISOLYTE S PH 7.4 IN PLASTIC CONTAINER	MAGNESIUM CHLORIDE; POTASSIUM CHLORIDE; POTASSIUM PHOSPHATE, MONOBASIC; SODIUM ACETATE; SODIUM CHLORIDE; SODIUM GLUCONATE; SODIUM PHOSPHATE, DIBASIC, HEPTAHYDRATE
GOLYTELY	POLYETHYLENE GLYCOL 3350; POTASSIUM CHLORIDE; SODIUM BICARBONATE; SODIUM CHLORIDE; SODIUM SULFATE ANHYDROUS
BENYLIN	DIPHENHYDRAMINE HYDROCHLORIDE; PSEUDOEPHEDRINE HYDROCHLORIDE
PHYSIOLYTE IN PLASTIC CONTAINER	MAGNESIUM CHLORIDE; POTASSIUM CHLORIDE; SODIUM ACETATE; SODIUM CHLORIDE; SODIUM GLUCONATE
ISOLYTE P W/ DEXTROSE 5% IN PLASTIC CONTAINER	DEXTROSE; MAGNESIUM CHLORIDE; POTASSIUM CHLORIDE; POTASSIUM PHOSPHATE, DIBASIC; SODIUM ACETATE
NORMOZIDE	HYDROCHLOROTHIAZIDE; LABETALOL HYDROCHLORIDE
PLASMA-LYTE 56 IN PLASTIC CONTAINER	MAGNESIUM ACETATE TETRAHYDRATE; POTASSIUM ACETATE; SODIUM CHLORIDE
INDERIDE LA 80/50	HYDROCHLOROTHIAZIDE; PROPRANOLOL HYDROCHLORIDE
INDERIDE LA 120/50	HYDROCHLOROTHIAZIDE; PROPRANOLOL HYDROCHLORIDE
INDERIDE LA 160/50	HYDROCHLOROTHIAZIDE; PROPRANOLOL HYDROCHLORIDE
TUSSIONEX PENNKINETIC	CHLORPHENIRAMINE POLISTIREX; HYDROCODONE POLISTIREX
AMINOSYN 3.5% W/ DEXTROSE 25% IN PLASTIC CONTAINER	AMINO ACIDS; DEXTROSE
AMINOSYN 4.25% W/ DEXTROSE 25% IN PLASTIC CONTAINER	AMINO ACIDS; DEXTROSE
AMINOSYN 3.5% W/ DEXTROSE 5% IN PLASTIC CONTAINER	AMINO ACIDS; DEXTROSE
MAXZIDE	HYDROCHLOROTHIAZIDE; TRIAMTERENE
MAXZIDE-25	HYDROCHLOROTHIAZIDE; TRIAMTERENE
TRANDATE HCT	HYDROCHLOROTHIAZIDE; LABETALOL HYDROCHLORIDE
TRIPHASIL-28	ETHINYL ESTRADIOL; LEVONORGESTREL
TRIPHASIL-21	ETHINYL ESTRADIOL; LEVONORGESTREL
VASERETIC	ENALAPRIL MALEATE; HYDROCHLOROTHIAZIDE
PAREMYD	HYDROXYAMPHETAMINE HYDROBROMIDE; TROPICAMIDE
DIMETANE-DX	BROMPHENIRAMINE MALEATE; DEXTROMETHORPHAN HYDROBROMIDE; PSEUDOEPHEDRINE HYDROCHLORIDE
OCL	POLYETHYLENE GLYCOL 3350; POTASSIUM CHLORIDE; SODIUM BICARBONATE; SODIUM CHLORIDE; SODIUM SULFATE
MD-76R	DIATRIZOATE MEGLUMINE; DIATRIZOATE SODIUM
POTASSIUM CHLORIDE 5MEQ IN DEXTROSE 5% AND SODIUM CHLORIDE 0.9% IN PLASTIC CONTAINER	DEXTROSE; POTASSIUM CHLORIDE; SODIUM CHLORIDE
POTASSIUM CHLORIDE 10MEQ IN DEXTROSE 5% AND SODIUM CHLORIDE 0.9% IN PLASTIC CONTAINER	DEXTROSE; POTASSIUM CHLORIDE; SODIUM CHLORIDE
POTASSIUM CHLORIDE 20MEQ IN DEXTROSE 5% AND SODIUM CHLORIDE 0.9% IN PLASTIC CONTAINER	DEXTROSE; POTASSIUM CHLORIDE; SODIUM CHLORIDE
POTASSIUM CHLORIDE 30MEQ IN DEXTROSE 5% AND SODIUM CHLORIDE 0.9% IN PLASTIC CONTAINER	DEXTROSE; POTASSIUM CHLORIDE; SODIUM CHLORIDE
POTASSIUM CHLORIDE 40MEQ IN DEXTROSE 5% AND SODIUM CHLORIDE 0.9% IN PLASTIC CONTAINER	DEXTROSE; POTASSIUM CHLORIDE; SODIUM CHLORIDE
SYNOVALYTE IN PLASTIC CONTAINER	MAGNESIUM CHLORIDE; POTASSIUM CHLORIDE; SODIUM ACETATE; SODIUM CHLORIDE; SODIUM GLUCONATE
AZO GANTRISIN	PHENAZOPYRIDINE HYDROCHLORIDE; SULFISOXAZOLE
POTASSIUM CHLORIDE 5MEQ IN DEXTROSE 5% AND LACTATED RINGER'S IN PLASTIC CONTAINER	CALCIUM CHLORIDE; DEXTROSE; POTASSIUM CHLORIDE; SODIUM CHLORIDE; SODIUM LACTATE
POTASSIUM CHLORIDE 10MEQ IN DEXTROSE 5% AND LACTATED RINGER'S IN PLASTIC CONTAINER	CALCIUM CHLORIDE; DEXTROSE; POTASSIUM CHLORIDE; SODIUM CHLORIDE; SODIUM LACTATE
POTASSIUM CHLORIDE 20MEQ IN DEXTROSE 5% AND LACTATED RINGER'S IN PLASTIC CONTAINER	CALCIUM CHLORIDE; DEXTROSE; POTASSIUM CHLORIDE; SODIUM CHLORIDE; SODIUM LACTATE
POTASSIUM CHLORIDE 15MEQ IN DEXTROSE 5% AND LACTATED RINGER'S IN PLASTIC CONTAINER	CALCIUM CHLORIDE; DEXTROSE; POTASSIUM CHLORIDE; SODIUM CHLORIDE; SODIUM LACTATE
POTASSIUM CHLORIDE 30MEQ IN DEXTROSE 5% AND LACTATED RINGER'S IN PLASTIC CONTAINER	CALCIUM CHLORIDE; DEXTROSE; POTASSIUM CHLORIDE; SODIUM CHLORIDE; SODIUM LACTATE
POTASSIUM CHLORIDE 40MEQ IN DEXTROSE 5% AND LACTATED RINGER'S IN PLASTIC CONTAINER	CALCIUM CHLORIDE; DEXTROSE; POTASSIUM CHLORIDE; SODIUM CHLORIDE; SODIUM LACTATE
INPERSOL-ZM W/ DEXTROSE 1.5% IN PLASTIC CONTAINER	CALCIUM CHLORIDE; DEXTROSE; SODIUM CHLORIDE; SODIUM LACTATE
INPERSOL-ZM W/ DEXTROSE 2.5% IN PLASTIC CONTAINER	CALCIUM CHLORIDE; DEXTROSE; SODIUM CHLORIDE; SODIUM LACTATE
INPERSOL-ZM W/ DEXTROSE 4.25% IN PLASTIC CONTAINER	CALCIUM CHLORIDE; DEXTROSE; SODIUM CHLORIDE; SODIUM LACTATE
FIORINAL W/CODEINE	ASPIRIN; BUTALBITAL; CAFFEINE; CODEINE PHOSPHATE
AMINOSYN II 10% W/ ELECTROLYTES	AMINO ACIDS; MAGNESIUM CHLORIDE; POTASSIUM CHLORIDE; POTASSIUM PHOSPHATE, DIBASIC; SODIUM CHLORIDE
AMINOSYN II 8.5% W/ ELECTROLYTES	AMINO ACIDS; MAGNESIUM CHLORIDE; POTASSIUM CHLORIDE; POTASSIUM PHOSPHATE, DIBASIC; SODIUM CHLORIDE
AMINOSYN II 7% W/ ELECTROLYTES	AMINO ACIDS; MAGNESIUM CHLORIDE; POTASSIUM CHLORIDE; POTASSIUM PHOSPHATE, DIBASIC; SODIUM CHLORIDE
AMINOSYN II 3.5% M	AMINO ACIDS; MAGNESIUM CHLORIDE; POTASSIUM CHLORIDE; SODIUM CHLORIDE; SODIUM PHOSPHATE, DIBASIC, HEPTAHYDRATE
AMINOSYN II 8.5% W/ELECTROLYTES	AMINO ACIDS; MAGNESIUM CHLORIDE; POTASSIUM CHLORIDE; SODIUM CHLORIDE; SODIUM PHOSPHATE, DIBASIC
NOVOLIN 70/30	INSULIN RECOMBINANT HUMAN; INSULIN SUSP ISOPHANE RECOMBINANT HUMAN
LOPRESSIDONE	CHLORTHALIDONE; METOPROLOL TARTRATE
DRIXORAL PLUS	ACETAMINOPHEN; DEXBROMPHENIRAMINE MALEATE; PSEUDOEPHEDRINE SULFATE
RENACIDIN	CITRIC ACID; GLUCONOLACTONE; MAGNESIUM CARBONATE
AMINOSYN II 3.5% M IN PLASTIC CONTAINER	AMINO ACIDS; MAGNESIUM ACETATE; POTASSIUM ACETATE; SODIUM CHLORIDE; SODIUM PHOSPHATE, DIBASIC, HEPTAHYDRATE
AMINOSYN II 4.25% IN DEXTROSE 25% IN PLASTIC CONTAINER	AMINO ACIDS; DEXTROSE
AMINOSYN II 3.5% IN DEXTROSE 25% IN PLASTIC CONTAINER	AMINO ACIDS; DEXTROSE
AMINOSYN II 3.5% IN DEXTROSE 5% IN PLASTIC CONTAINER	AMINO ACIDS; DEXTROSE
IONOSOL MB AND DEXTROSE 5% IN PLASTIC CONTAINER	DEXTROSE; MAGNESIUM CHLORIDE; POTASSIUM CHLORIDE; POTASSIUM PHOSPHATE, MONOBASIC; SODIUM LACTATE; SODIUM PHOSPHATE, MONOBASIC ANHYDROUS
IONOSOL T AND DEXTROSE 5% IN PLASTIC CONTAINER	DEXTROSE; POTASSIUM CHLORIDE; POTASSIUM LACTATE; SODIUM CHLORIDE; SODIUM PHOSPHATE, MONOBASIC ANHYDROUS
IONOSOL B AND DEXTROSE 5% IN PLASTIC CONTAINER	DEXTROSE; MAGNESIUM CHLORIDE; POTASSIUM CHLORIDE; POTASSIUM PHOSPHATE, DIBASIC; SODIUM CHLORIDE; SODIUM LACTATE; SODIUM PHOSPHATE, MONOBASIC ANHYDROUS
TRAVASOL 2.75% IN DEXTROSE 5% IN PLASTIC CONTAINER	AMINO ACIDS; DEXTROSE
TRAVASOL 2.75% IN DEXTROSE 10% IN PLASTIC CONTAINER	AMINO ACIDS; DEXTROSE
TRAVASOL 2.75% IN DEXTROSE 15% IN PLASTIC CONTAINER	AMINO ACIDS; DEXTROSE
TRAVASOL 2.75% IN DEXTROSE 20% IN PLASTIC CONTAINER	AMINO ACIDS; DEXTROSE
TRAVASOL 2.75% IN DEXTROSE 25% IN PLASTIC CONTAINER	AMINO ACIDS; DEXTROSE
TRAVASOL 4.25% IN DEXTROSE 5% IN PLASTIC CONTAINER	AMINO ACIDS; DEXTROSE
TRAVASOL 4.25% IN DEXTROSE 10% IN PLASTIC CONTAINER	AMINO ACIDS; DEXTROSE
TRAVASOL 4.25% IN DEXTROSE 15% IN PLASTIC CONTAINER	AMINO ACIDS; DEXTROSE
TRAVASOL 4.25% IN DEXTROSE 20% IN PLASTIC CONTAINER	AMINO ACIDS; DEXTROSE
TRAVASOL 4.25% IN DEXTROSE 25% IN PLASTIC CONTAINER	AMINO ACIDS; DEXTROSE
FML-S	FLUOROMETHOLONE; SULFACETAMIDE SODIUM
UCEPHAN	SODIUM BENZOATE; SODIUM PHENYLACETATE
AMINOSYN II 3.5% M IN DEXTROSE 5% IN PLASTIC CONTAINER	AMINO ACIDS; DEXTROSE; MAGNESIUM CHLORIDE; POTASSIUM CHLORIDE; SODIUM CHLORIDE; SODIUM PHOSPHATE, DIBASIC, HEPTAHYDRATE
AMINOSYN II 3.5% W/ ELECTROLYTES IN DEXTROSE 25% IN PLASTIC CONTAINER	AMINO ACIDS; DEXTROSE; MAGNESIUM CHLORIDE; POTASSIUM CHLORIDE; POTASSIUM PHOSPHATE, DIBASIC; SODIUM CHLORIDE
AMINOSYN II 4.25% M IN DEXTROSE 10% IN PLASTIC CONTAINER	AMINO ACIDS; DEXTROSE; MAGNESIUM CHLORIDE; POTASSIUM CHLORIDE; SODIUM CHLORIDE; SODIUM PHOSPHATE, DIBASIC, HEPTAHYDRATE
AMINOSYN II 4.25% W/ ELECTROLYTES IN DEXTROSE 25% IN PLASTIC CONTAINER	AMINO ACIDS; DEXTROSE; MAGNESIUM CHLORIDE; POTASSIUM CHLORIDE; POTASSIUM PHOSPHATE, DIBASIC; SODIUM CHLORIDE
AMINOSYN II 5% IN DEXTROSE 25% IN PLASTIC CONTAINER	AMINO ACIDS; DEXTROSE
MIXTARD HUMAN 70/30	INSULIN RECOMBINANT PURIFIED HUMAN; INSULIN SUSP ISOPHANE SEMISYNTHETIC PURIFIED HUMAN
POTASSIUM CHLORIDE 0.037% IN DEXTROSE 5% AND SODIUM CHLORIDE 0.11% IN PLASTIC CONTAINER	DEXTROSE; POTASSIUM CHLORIDE; SODIUM CHLORIDE
POTASSIUM CHLORIDE 0.075% IN DEXTROSE 5% AND SODIUM CHLORIDE 0.11% IN PLASTIC CONTAINER	DEXTROSE; POTASSIUM CHLORIDE; SODIUM CHLORIDE
POTASSIUM CHLORIDE 0.11% IN DEXTROSE 5% AND SODIUM CHLORIDE 0.11% IN PLASTIC CONTAINER	DEXTROSE; POTASSIUM CHLORIDE; SODIUM CHLORIDE
POTASSIUM CHLORIDE 0.15% IN DEXTROSE 5% AND SODIUM CHLORIDE 0.11% IN PLASTIC CONTAINER	DEXTROSE; POTASSIUM CHLORIDE; SODIUM CHLORIDE
POTASSIUM CHLORIDE 0.22% IN DEXTROSE 5% AND SODIUM CHLORIDE 0.11% IN PLASTIC CONTAINER	DEXTROSE; POTASSIUM CHLORIDE; SODIUM CHLORIDE
POTASSIUM CHLORIDE 0.3% IN DEXTROSE 5% AND SODIUM CHLORIDE 0.11% IN PLASTIC CONTAINER	DEXTROSE; POTASSIUM CHLORIDE; SODIUM CHLORIDE
POTASSIUM CHLORIDE 0.037% IN DEXTROSE 5% AND SODIUM CHLORIDE 0.2% IN PLASTIC CONTAINER	DEXTROSE; POTASSIUM CHLORIDE; SODIUM CHLORIDE
POTASSIUM CHLORIDE 0.075% IN DEXTROSE 5% AND SODIUM CHLORIDE 0.2% IN PLASTIC CONTAINER	DEXTROSE; POTASSIUM CHLORIDE; SODIUM CHLORIDE
POTASSIUM CHLORIDE 0.11% IN DEXTROSE 5% AND SODIUM CHLORIDE 0.2% IN PLASTIC CONTAINER	DEXTROSE; POTASSIUM CHLORIDE; SODIUM CHLORIDE
POTASSIUM CHLORIDE 0.15% IN DEXTROSE 5% AND SODIUM CHLORIDE 0.2% IN PLASTIC CONTAINER	DEXTROSE; POTASSIUM CHLORIDE; SODIUM CHLORIDE
POTASSIUM CHLORIDE 0.22% IN DEXTROSE 5% AND SODIUM CHLORIDE 0.2% IN PLASTIC CONTAINER	DEXTROSE; POTASSIUM CHLORIDE; SODIUM CHLORIDE
POTASSIUM CHLORIDE 0.3% IN DEXTROSE 5% AND SODIUM CHLORIDE 0.2% IN PLASTIC CONTAINER	DEXTROSE; POTASSIUM CHLORIDE; SODIUM CHLORIDE
POTASSIUM CHLORIDE 0.037% IN DEXTROSE 5% AND SODIUM CHLORIDE 0.33% IN PLASTIC CONTAINER	DEXTROSE; POTASSIUM CHLORIDE; SODIUM CHLORIDE
POTASSIUM CHLORIDE 0.075% IN DEXTROSE 5% AND SODIUM CHLORIDE 0.33% IN PLASTIC CONTAINER	DEXTROSE; POTASSIUM CHLORIDE; SODIUM CHLORIDE
POTASSIUM CHLORIDE 0.11% IN DEXTROSE 5% AND SODIUM CHLORIDE 0.33% IN PLASTIC CONTAINER	DEXTROSE; POTASSIUM CHLORIDE; SODIUM CHLORIDE
POTASSIUM CHLORIDE 0.15% IN DEXTROSE 5% AND SODIUM CHLORIDE 0.33% IN PLASTIC CONTAINER	DEXTROSE; POTASSIUM CHLORIDE; SODIUM CHLORIDE
POTASSIUM CHLORIDE 0.22% IN DEXTROSE 5% AND SODIUM CHLORIDE 0.33% IN PLASTIC CONTAINER	DEXTROSE; POTASSIUM CHLORIDE; SODIUM CHLORIDE
POTASSIUM CHLORIDE 0.3% IN DEXTROSE 5% AND SODIUM CHLORIDE 0.33% IN PLASTIC CONTAINER	DEXTROSE; POTASSIUM CHLORIDE; SODIUM CHLORIDE
POTASSIUM CHLORIDE 0.037% IN DEXTROSE 5% AND SODIUM CHLORIDE 0.45% IN PLASTIC CONTAINER	DEXTROSE; POTASSIUM CHLORIDE; SODIUM CHLORIDE
POTASSIUM CHLORIDE 0.075% IN DEXTROSE 5% AND SODIUM CHLORIDE 0.45% IN PLASTIC CONTAINER	DEXTROSE; POTASSIUM CHLORIDE; SODIUM CHLORIDE
POTASSIUM CHLORIDE 0.11% IN DEXTROSE 5% AND SODIUM CHLORIDE 0.45% IN PLASTIC CONTAINER	DEXTROSE; POTASSIUM CHLORIDE; SODIUM CHLORIDE
POTASSIUM CHLORIDE 0.15% IN DEXTROSE 5% AND SODIUM CHLORIDE 0.45% IN PLASTIC CONTAINER	DEXTROSE; POTASSIUM CHLORIDE; SODIUM CHLORIDE
POTASSIUM CHLORIDE 0.22% IN DEXTROSE 5% AND SODIUM CHLORIDE 0.45% IN PLASTIC CONTAINER	DEXTROSE; POTASSIUM CHLORIDE; SODIUM CHLORIDE
POTASSIUM CHLORIDE 0.3% IN DEXTROSE 5% AND SODIUM CHLORIDE 0.45% IN PLASTIC CONTAINER	DEXTROSE; POTASSIUM CHLORIDE; SODIUM CHLORIDE
POTASSIUM CHLORIDE 0.037% IN DEXTROSE 5% AND SODIUM CHLORIDE 0.9% IN PLASTIC CONTAINER	DEXTROSE; POTASSIUM CHLORIDE; SODIUM CHLORIDE
POTASSIUM CHLORIDE 0.075% IN DEXTROSE 5% AND SODIUM CHLORIDE 0.9% IN PLASTIC CONTAINER	DEXTROSE; POTASSIUM CHLORIDE; SODIUM CHLORIDE
POTASSIUM CHLORIDE 0.11% IN DEXTROSE 5% AND SODIUM CHLORIDE 0.9% IN PLASTIC CONTAINER	DEXTROSE; POTASSIUM CHLORIDE; SODIUM CHLORIDE
POTASSIUM CHLORIDE 0.15% IN DEXTROSE 5% AND SODIUM CHLORIDE 0.9% IN PLASTIC CONTAINER	DEXTROSE; POTASSIUM CHLORIDE; SODIUM CHLORIDE
POTASSIUM CHLORIDE 0.22% IN DEXTROSE 5% AND SODIUM CHLORIDE 0.9% IN PLASTIC CONTAINER	DEXTROSE; POTASSIUM CHLORIDE; SODIUM CHLORIDE
POTASSIUM CHLORIDE 0.3% IN DEXTROSE 5% AND SODIUM CHLORIDE 0.9% IN PLASTIC CONTAINER	DEXTROSE; POTASSIUM CHLORIDE; SODIUM CHLORIDE
POTASSIUM CHLORIDE 0.037% IN DEXTROSE 10% AND SODIUM CHLORIDE 0.2% IN PLASTIC CONTAINER	DEXTROSE; POTASSIUM CHLORIDE; SODIUM CHLORIDE
POTASSIUM CHLORIDE 0.075% IN DEXTROSE 10% AND SODIUM CHLORIDE 0.2% IN PLASTIC CONTAINER	DEXTROSE; POTASSIUM CHLORIDE; SODIUM CHLORIDE
POTASSIUM CHLORIDE 0.11% IN DEXTROSE 10% AND SODIUM CHLORIDE 0.2% IN PLASTIC CONTAINER	DEXTROSE; POTASSIUM CHLORIDE; SODIUM CHLORIDE
POTASSIUM CHLORIDE 0.15% IN DEXTROSE 10% AND SODIUM CHLORIDE 0.2% IN PLASTIC CONTAINER	DEXTROSE; POTASSIUM CHLORIDE; SODIUM CHLORIDE
POTASSIUM CHLORIDE 0.22% IN DEXTROSE 10% AND SODIUM CHLORIDE 0.2% IN PLASTIC CONTAINER	DEXTROSE; POTASSIUM CHLORIDE; SODIUM CHLORIDE
POTASSIUM CHLORIDE 0.3% IN DEXTROSE 10% AND SODIUM CHLORIDE 0.2% IN PLASTIC CONTAINER	DEXTROSE; POTASSIUM CHLORIDE; SODIUM CHLORIDE
POTASSIUM CHLORIDE 0.037% IN DEXTROSE 10% AND SODIUM CHLORIDE 0.45% IN PLASTIC CONTAINER	DEXTROSE; POTASSIUM CHLORIDE; SODIUM CHLORIDE
POTASSIUM CHLORIDE 0.075% IN DEXTROSE 10% AND SODIUM CHLORIDE 0.45% IN PLASTIC CONTAINER	DEXTROSE; POTASSIUM CHLORIDE; SODIUM CHLORIDE
POTASSIUM CHLORIDE 0.11% IN DEXTROSE 10% AND SODIUM CHLORIDE 0.45% IN PLASTIC CONTAINER	DEXTROSE; POTASSIUM CHLORIDE; SODIUM CHLORIDE
POTASSIUM CHLORIDE 0.15% IN DEXTROSE 10% AND SODIUM CHLORIDE 0.45% IN PLASTIC CONTAINER	DEXTROSE; POTASSIUM CHLORIDE; SODIUM CHLORIDE
POTASSIUM CHLORIDE 0.22% IN DEXTROSE 10% AND SODIUM CHLORIDE 0.45% IN PLASTIC CONTAINER	DEXTROSE; POTASSIUM CHLORIDE; SODIUM CHLORIDE
POTASSIUM CHLORIDE 0.3% IN DEXTROSE 10% AND SODIUM CHLORIDE 0.45% IN PLASTIC CONTAINER	DEXTROSE; POTASSIUM CHLORIDE; SODIUM CHLORIDE
POTASSIUM CHLORIDE 0.037% IN DEXTROSE 10% AND SODIUM CHLORIDE 0.9% IN PLASTIC CONTAINER	DEXTROSE; POTASSIUM CHLORIDE; SODIUM CHLORIDE
POTASSIUM CHLORIDE 0.075% IN DEXTROSE 10% AND SODIUM CHLORIDE 0.9% IN PLASTIC CONTAINER	DEXTROSE; POTASSIUM CHLORIDE; SODIUM CHLORIDE
POTASSIUM CHLORIDE 0.11% IN DEXTROSE 10% AND SODIUM CHLORIDE 0.9% IN PLASTIC CONTAINER	DEXTROSE; POTASSIUM CHLORIDE; SODIUM CHLORIDE
POTASSIUM CHLORIDE 0.15% IN DEXTROSE 10% AND SODIUM CHLORIDE 0.9% IN PLASTIC CONTAINER	DEXTROSE; POTASSIUM CHLORIDE; SODIUM CHLORIDE
POTASSIUM CHLORIDE 0.22% IN DEXTROSE 10% AND SODIUM CHLORIDE 0.9% IN PLASTIC CONTAINER	DEXTROSE; POTASSIUM CHLORIDE; SODIUM CHLORIDE
POTASSIUM CHLORIDE 0.3% IN DEXTROSE 10% AND SODIUM CHLORIDE 0.9% IN PLASTIC CONTAINER	DEXTROSE; POTASSIUM CHLORIDE; SODIUM CHLORIDE
POTASSIUM CHLORIDE 0.075% IN DEXTROSE 3.3% AND SODIUM CHLORIDE 0.3% IN PLASTIC CONTAINER	DEXTROSE; POTASSIUM CHLORIDE; SODIUM CHLORIDE
POTASSIUM CHLORIDE 0.11% IN DEXTROSE 3.3% AND SODIUM CHLORIDE 0.3% IN PLASTIC CONTAINER	DEXTROSE; POTASSIUM CHLORIDE; SODIUM CHLORIDE
POTASSIUM CHLORIDE 0.15% IN DEXTROSE 3.3% AND SODIUM CHLORIDE 0.3% IN PLASTIC CONTAINER	DEXTROSE; POTASSIUM CHLORIDE; SODIUM CHLORIDE
POTASSIUM CHLORIDE 0.22% IN DEXTROSE 3.3% AND SODIUM CHLORIDE 0.3% IN PLASTIC CONTAINER	DEXTROSE; POTASSIUM CHLORIDE; SODIUM CHLORIDE
POTASSIUM CHLORIDE 0.3% IN DEXTROSE 3.3% AND SODIUM CHLORIDE 0.3% IN PLASTIC CONTAINER	DEXTROSE; POTASSIUM CHLORIDE; SODIUM CHLORIDE
DEXTROSE 2.5% AND SODIUM CHLORIDE 0.11% IN PLASTIC CONTAINER	DEXTROSE; SODIUM CHLORIDE
DEXTROSE 2.5% AND SODIUM CHLORIDE 0.2% IN PLASTIC CONTAINER	DEXTROSE; SODIUM CHLORIDE
DEXTROSE 2.5% AND SODIUM CHLORIDE 0.33% IN PLASTIC CONTAINER	DEXTROSE; SODIUM CHLORIDE
DEXTROSE 10% AND SODIUM CHLORIDE 0.11% IN PLASTIC CONTAINER	DEXTROSE; SODIUM CHLORIDE
DEXTROSE 10% AND SODIUM CHLORIDE 0.33% IN PLASTIC CONTAINER	DEXTROSE; SODIUM CHLORIDE
DEXTROSE 2.5% IN HALF-STRENGTH LACTATED RINGER'S IN PLASTIC CONTAINER	CALCIUM CHLORIDE; DEXTROSE; POTASSIUM CHLORIDE; SODIUM CHLORIDE; SODIUM LACTATE
DEXTROSE 4% IN MODIFIED LACTATED RINGER'S IN PLASTIC CONTAINER	CALCIUM CHLORIDE; DEXTROSE; POTASSIUM CHLORIDE; SODIUM CHLORIDE; SODIUM LACTATE
ORTHO CYCLEN-21	ETHINYL ESTRADIOL; NORGESTIMATE
ORTHO CYCLEN-28	ETHINYL ESTRADIOL; NORGESTIMATE
CLARITIN-D	LORATADINE; PSEUDOEPHEDRINE SULFATE
EFIDAC 24 PSEUDOEPHEDRINE HYDROCHLORIDE/BROMPHENIRAMINE MALEATE	BROMPHENIRAMINE MALEATE; PSEUDOEPHEDRINE HYDROCHLORIDE
ENLON-PLUS	ATROPINE SULFATE; EDROPHONIUM CHLORIDE
AMINOSYN II 4.25% IN DEXTROSE 10% IN PLASTIC CONTAINER	AMINO ACIDS; DEXTROSE
AMINOSYN II 4.25% IN DEXTROSE 20% IN PLASTIC CONTAINER	AMINO ACIDS; DEXTROSE
AMINOSYN II 4.25% W/ ELECT AND ADJUSTED PHOSPHATE IN DEXTROSE 10% IN PLASTIC CONTAINER	AMINO ACIDS; DEXTROSE; MAGNESIUM CHLORIDE; POTASSIUM ACETATE; POTASSIUM CHLORIDE; POTASSIUM PHOSPHATE, DIBASIC; SODIUM CHLORIDE
AMINOSYN II 3.5% W/ ELECTROLYTES IN DEXTROSE 25% W/ CALCIUM IN PLASTIC CONTAINER	AMINO ACIDS; CALCIUM CHLORIDE; DEXTROSE; MAGNESIUM CHLORIDE; POTASSIUM CHLORIDE; POTASSIUM PHOSPHATE, DIBASIC; SODIUM CHLORIDE
AMINOSYN II 4.25% W/ ELECTROLYTES IN DEXTROSE 20% W/ CALCIUM IN PLASTIC CONTAINER	AMINO ACIDS; CALCIUM CHLORIDE; DEXTROSE; MAGNESIUM CHLORIDE; POTASSIUM CHLORIDE; POTASSIUM PHOSPHATE, DIBASIC; SODIUM CHLORIDE
AMINOSYN II 4.25% W/ ELECTROLYTES IN DEXTROSE 25% W/ CALCIUM IN PLASTIC CONTAINER	AMINO ACIDS; CALCIUM CHLORIDE; DEXTROSE; MAGNESIUM CHLORIDE; POTASSIUM CHLORIDE; POTASSIUM PHOSPHATE, DIBASIC; SODIUM CHLORIDE
AMINOSYN II 5% W/ ELECTROLYTES IN DEXTROSE 25% W/ CALCIUM IN PLASTIC CONTAINER	AMINO ACIDS; CALCIUM CHLORIDE; DEXTROSE; MAGNESIUM CHLORIDE; POTASSIUM CHLORIDE; POTASSIUM PHOSPHATE, DIBASIC; SODIUM CHLORIDE
POTASSIUM CHLORIDE 20MEQ IN SODIUM CHLORIDE 0.9% IN PLASTIC CONTAINER	POTASSIUM CHLORIDE; SODIUM CHLORIDE
POTASSIUM CHLORIDE 40MEQ IN SODIUM CHLORIDE 0.9% IN PLASTIC CONTAINER	POTASSIUM CHLORIDE; SODIUM CHLORIDE
POTASSIUM CHLORIDE 15MEQ IN DEXTROSE 5% AND SODIUM CHLORIDE 0.9% IN PLASTIC CONTAINER	DEXTROSE; POTASSIUM CHLORIDE; SODIUM CHLORIDE
ORTHO TRI-CYCLEN	ETHINYL ESTRADIOL; NORGESTIMATE
POTASSIUM CHLORIDE 0.037% IN DEXTROSE 5% IN PLASTIC CONTAINER	DEXTROSE; POTASSIUM CHLORIDE
POTASSIUM CHLORIDE 0.11% IN DEXTROSE 5% IN PLASTIC CONTAINER	DEXTROSE; POTASSIUM CHLORIDE
POTASSIUM CHLORIDE 0.037% IN SODIUM CHLORIDE 0.9% IN PLASTIC CONTAINER	POTASSIUM CHLORIDE; SODIUM CHLORIDE
POTASSIUM CHLORIDE 0.075% IN SODIUM CHLORIDE 0.9% IN PLASTIC CONTAINER	POTASSIUM CHLORIDE; SODIUM CHLORIDE
POTASSIUM CHLORIDE 0.11% IN SODIUM CHLORIDE 0.9% IN PLASTIC CONTAINER	POTASSIUM CHLORIDE; SODIUM CHLORIDE
POTASSIUM CHLORIDE 0.22% IN SODIUM CHLORIDE 0.9% IN PLASTIC CONTAINER	POTASSIUM CHLORIDE; SODIUM CHLORIDE
POTASSIUM CHLORIDE 0.3% IN SODIUM CHLORIDE 0.9% IN PLASTIC CONTAINER	POTASSIUM CHLORIDE; SODIUM CHLORIDE
HUMULIN 70/30	INSULIN RECOMBINANT HUMAN; INSULIN SUSP ISOPHANE RECOMBINANT HUMAN
HUMULIN 70/30 PEN	INSULIN RECOMBINANT HUMAN; INSULIN SUSP ISOPHANE RECOMBINANT HUMAN
IFEX/MESNEX KIT	IFOSFAMIDE; MESNA
ADVIL COLD AND SINUS	IBUPROFEN; PSEUDOEPHEDRINE HYDROCHLORIDE
PRINZIDE	HYDROCHLOROTHIAZIDE; LISINOPRIL
NULYTELY	POLYETHYLENE GLYCOL 3350; POTASSIUM CHLORIDE; SODIUM BICARBONATE; SODIUM CHLORIDE
NULYTELY-FLAVORED	POLYETHYLENE GLYCOL 3350; POTASSIUM CHLORIDE; SODIUM BICARBONATE; SODIUM CHLORIDE
SEMPREX-D	ACRIVASTINE; PSEUDOEPHEDRINE HYDROCHLORIDE
KERLEDEX	BETAXOLOL HYDROCHLORIDE; CHLORTHALIDONE
ISOLYTE S IN DEXTROSE 5% IN PLASTIC CONTAINER	DEXTROSE; MAGNESIUM CHLORIDE; POTASSIUM CHLORIDE; SODIUM ACETATE; SODIUM CHLORIDE; SODIUM GLUCONATE
ISOLYTE H IN DEXTROSE 5% IN PLASTIC CONTAINER	DEXTROSE; MAGNESIUM CHLORIDE; POTASSIUM CHLORIDE; SODIUM ACETATE; SODIUM CHLORIDE
SINEMET CR	CARBIDOPA; LEVODOPA
ISOLYTE R IN DEXTROSE 5% IN PLASTIC CONTAINER	CALCIUM CHLORIDE; DEXTROSE; MAGNESIUM CHLORIDE; POTASSIUM CHLORIDE; SODIUM ACETATE; SODIUM CHLORIDE
ISOLYTE E IN DEXTROSE 5% IN PLASTIC CONTAINER	CALCIUM CHLORIDE; DEXTROSE; MAGNESIUM CHLORIDE; POTASSIUM CHLORIDE; SODIUM ACETATE; SODIUM CHLORIDE; SODIUM CITRATE
ISOLYTE M IN DEXTROSE 5% IN PLASTIC CONTAINER	DEXTROSE; POTASSIUM CHLORIDE; POTASSIUM PHOSPHATE, DIBASIC; SODIUM ACETATE; SODIUM CHLORIDE
ISOLYTE P IN DEXTROSE 5% IN PLASTIC CONTAINER	DEXTROSE; MAGNESIUM CHLORIDE; POTASSIUM CHLORIDE; POTASSIUM PHOSPHATE, DIBASIC; SODIUM ACETATE
ZESTORETIC	HYDROCHLOROTHIAZIDE; LISINOPRIL
SINE-AID IB	IBUPROFEN; PSEUDOEPHEDRINE HYDROCHLORIDE
EMLA	LIDOCAINE; PRILOCAINE
LOTENSIN HCT	BENAZEPRIL HYDROCHLORIDE; HYDROCHLOROTHIAZIDE
EXOSURF NEONATAL	CETYL ALCOHOL; COLFOSCERIL PALMITATE; TYLOXAPOL
SHADE UVAGUARD	AVOBENZONE; OCTINOXATE; OXYBENZONE
MACROBID	NITROFURANTOIN; NITROFURANTOIN, MACROCRYSTALLINE
OPCON-A	NAPHAZOLINE HYDROCHLORIDE; PHENIRAMINE MALEATE
DESOGEN	DESOGESTREL; ETHINYL ESTRADIOL
METHOTREXATE SODIUM	CALCIUM CHLORIDE; DEXTROSE; GLUTATHIONE DISULFIDE; MAGNESIUM CHLORIDE; POTASSIUM CHLORIDE; SODIUM BICARBONATE; SODIUM CHLORIDE; SODIUM PHOSPHATE
HUMULIN 50/50	INSULIN RECOMBINANT HUMAN; INSULIN SUSP ISOPHANE RECOMBINANT HUMAN
ACCURETIC	HYDROCHLOROTHIAZIDE; QUINAPRIL HYDROCHLORIDE
ESTROSTEP 21	ETHINYL ESTRADIOL; NORETHINDRONE ACETATE
ESTROSTEP FE	ETHINYL ESTRADIOL; NORETHINDRONE ACETATE
TRAVASOL 2.75% SULFITE FREE W/ ELECTROLYTES IN DEXTROSE 5% IN PLASTIC CONTAINER	AMINO ACIDS; DEXTROSE; MAGNESIUM CHLORIDE; POTASSIUM PHOSPHATE, DIBASIC; SODIUM ACETATE; SODIUM CHLORIDE
TRAVASOL 2.75% SULFITE FREE W/ ELECTROLYTES IN DEXTROSE 10% IN PLASTIC CONTAINER	AMINO ACIDS; DEXTROSE; MAGNESIUM CHLORIDE; POTASSIUM PHOSPHATE, DIBASIC; SODIUM ACETATE; SODIUM CHLORIDE
TRAVASOL 2.75% SULFITE FREE W/ ELECTROLYTES IN DEXTROSE 15% IN PLASTIC CONTAINER	AMINO ACIDS; DEXTROSE; MAGNESIUM CHLORIDE; POTASSIUM PHOSPHATE, DIBASIC; SODIUM ACETATE; SODIUM CHLORIDE
TRAVASOL 2.75% SULFITE FREE W/ ELECTROLYTES IN DEXTROSE 20% IN PLASTIC CONTAINER	AMINO ACIDS; DEXTROSE; MAGNESIUM CHLORIDE; POTASSIUM PHOSPHATE, DIBASIC; SODIUM ACETATE; SODIUM CHLORIDE
TRAVASOL 2.75% SULFITE FREE W/ ELECTROLYTES IN DEXTROSE 25% IN PLASTIC CONTAINER	AMINO ACIDS; DEXTROSE; MAGNESIUM CHLORIDE; POTASSIUM PHOSPHATE, DIBASIC; SODIUM ACETATE; SODIUM CHLORIDE
TRAVASOL 4.25% SULFITE FREE W/ ELECTROLYTES IN DEXTROSE 5% IN PLASTIC CONTAINER	AMINO ACIDS; DEXTROSE; MAGNESIUM CHLORIDE; POTASSIUM PHOSPHATE, DIBASIC; SODIUM ACETATE; SODIUM CHLORIDE
TRAVASOL 4.25% SULFITE FREE W/ ELECTROLYTES IN DEXTROSE 10% IN PLASTIC CONTAINER	AMINO ACIDS; DEXTROSE; MAGNESIUM CHLORIDE; POTASSIUM PHOSPHATE, DIBASIC; SODIUM ACETATE; SODIUM CHLORIDE
TRAVASOL 4.25% SULFITE FREE W/ ELECTROLYTES IN DEXTROSE 15% IN PLASTIC CONTAINER	AMINO ACIDS; DEXTROSE; MAGNESIUM CHLORIDE; POTASSIUM PHOSPHATE, DIBASIC; SODIUM ACETATE; SODIUM CHLORIDE
TRAVASOL 4.25% SULFITE FREE W/ ELECTROLYTES IN DEXTROSE 20% IN PLASTIC CONTAINER	AMINO ACIDS; DEXTROSE; MAGNESIUM CHLORIDE; POTASSIUM PHOSPHATE, DIBASIC; SODIUM ACETATE; SODIUM CHLORIDE
TRAVASOL 4.25% SULFITE FREE W/ ELECTROLYTES IN DEXTROSE 25% IN PLASTIC CONTAINER	AMINO ACIDS; DEXTROSE; MAGNESIUM CHLORIDE; POTASSIUM PHOSPHATE, DIBASIC; SODIUM ACETATE; SODIUM CHLORIDE
DELFLEX W/ DEXTROSE 1.5% LOW MAGNESIUM LOW CALCIUM IN PLASTIC CONTAINER	CALCIUM CHLORIDE; DEXTROSE; MAGNESIUM CHLORIDE; SODIUM CHLORIDE; SODIUM LACTATE
DELFLEX W/ DEXTROSE 2.5% LOW MAGNESIUM LOW CALCIUM IN PLASTIC CONTAINER	CALCIUM CHLORIDE; DEXTROSE; MAGNESIUM CHLORIDE; SODIUM CHLORIDE; SODIUM LACTATE
DELFLEX W/ DEXTROSE 4.25% LOW MAGNESIUM LOW CALCIUM IN PLASTIC CONTAINER	CALCIUM CHLORIDE; DEXTROSE; MAGNESIUM CHLORIDE; SODIUM CHLORIDE; SODIUM LACTATE
TRAVASOL 5.5% SULFITE FREE W/ ELECTROLYTES IN PLASTIC CONTAINER	AMINO ACIDS; MAGNESIUM CHLORIDE; POTASSIUM PHOSPHATE, DIBASIC; SODIUM ACETATE; SODIUM CHLORIDE
TRAVASOL 8.5% SULFITE FREE W/ ELECTROLYTES IN PLASTIC CONTAINER	AMINO ACIDS; MAGNESIUM CHLORIDE; POTASSIUM PHOSPHATE, DIBASIC; SODIUM ACETATE; SODIUM CHLORIDE
VITAPED	ASCORBIC ACID; BIOTIN; CYANOCOBALAMIN; ERGOCALCIFEROL; FOLIC ACID; NIACINAMIDE; PANTOTHENIC ACID; PHYTONADIONE; PYRIDOXINE; RIBOFLAVIN; THIAMINE; VITAMIN A PALMITATE; VITAMIN E
TRAVASOL 3.5% SULFITE FREE W/ ELECTROLYTES IN PLASTIC CONTAINER	AMINO ACIDS; MAGNESIUM CHLORIDE; POTASSIUM PHOSPHATE, DIBASIC; SODIUM ACETATE; SODIUM CHLORIDE
DIANEAL LOW CALCIUM W/ DEXTROSE 1.5% IN PLASTIC CONTAINER	CALCIUM CHLORIDE; DEXTROSE; MAGNESIUM CHLORIDE; SODIUM CHLORIDE; SODIUM LACTATE
DIANEAL LOW CALCIUM W/ DEXTROSE 2.5% IN PLASTIC CONTAINER	CALCIUM CHLORIDE; DEXTROSE; MAGNESIUM CHLORIDE; SODIUM CHLORIDE; SODIUM LACTATE
DIANEAL LOW CALCIUM W/ DEXTROSE 3.5% IN PLASTIC CONTAINER	CALCIUM CHLORIDE; DEXTROSE; MAGNESIUM CHLORIDE; SODIUM CHLORIDE; SODIUM LACTATE
DIANEAL LOW CALCIUM W/ DEXTROSE 4.25% IN PLASTIC CONTAINER	CALCIUM CHLORIDE; DEXTROSE; MAGNESIUM CHLORIDE; SODIUM CHLORIDE; SODIUM LACTATE
ZIAC	BISOPROLOL FUMARATE; HYDROCHLOROTHIAZIDE
NAPHCON-A	NAPHAZOLINE HYDROCHLORIDE; PHENIRAMINE MALEATE
COLGATE TOTAL	SODIUM FLUORIDE; TRICLOSAN
FIORICET W/ CODEINE	ACETAMINOPHEN; BUTALBITAL; CAFFEINE; CODEINE PHOSPHATE
MONOPRIL-HCT	FOSINOPRIL SODIUM; HYDROCHLOROTHIAZIDE
COMBIVENT	ALBUTEROL SULFATE; IPRATROPIUM BROMIDE
ORTHO-CEPT	DESOGESTREL; ETHINYL ESTRADIOL
PREMPRO (PREMARIN;CYCRIN)	ESTROGENS, CONJUGATED; MEDROXYPROGESTERONE ACETATE
PREMPHASE (PREMARIN;CYCRIN 14/14)	ESTROGENS, CONJUGATED; MEDROXYPROGESTERONE ACETATE
HUMEGON	MENOTROPINS (FSH;LH)
LOTREL	AMLODIPINE BESYLATE; BENAZEPRIL HYDROCHLORIDE
INPERSOL-LC/LM W/ DEXTROSE 1.5% IN PLASTIC CONTAINER	CALCIUM CHLORIDE; DEXTROSE; MAGNESIUM CHLORIDE; SODIUM CHLORIDE; SODIUM LACTATE
INPERSOL-LC/LM W/ DEXTROSE 2.5% IN PLASTIC CONTAINER	CALCIUM CHLORIDE; DEXTROSE; MAGNESIUM CHLORIDE; SODIUM CHLORIDE; SODIUM LACTATE
INPERSOL-LC/LM W/ DEXTROSE 3.5% IN PLASTIC CONTAINER	CALCIUM CHLORIDE; DEXTROSE; MAGNESIUM CHLORIDE; SODIUM CHLORIDE; SODIUM LACTATE
INPERSOL-LC/LM W/ DEXTROSE 4.25% IN PLASTIC CONTAINER	CALCIUM CHLORIDE; DEXTROSE; MAGNESIUM CHLORIDE; SODIUM CHLORIDE; SODIUM LACTATE
HYZAAR	HYDROCHLOROTHIAZIDE; LOSARTAN POTASSIUM
CLARITIN-D 24 HOUR	LORATADINE; PSEUDOEPHEDRINE SULFATE
VISINE	NAPHAZOLINE HYDROCHLORIDE; PHENIRAMINE MALEATE
TECZEM	DILTIAZEM MALATE; ENALAPRIL MALEATE
PREMPRO	ESTROGENS, CONJUGATED; MEDROXYPROGESTERONE ACETATE
PREMPHASE 14/14	ESTROGENS, CONJUGATED; MEDROXYPROGESTERONE ACETATE
IONTOCAINE	EPINEPHRINE; LIDOCAINE HYDROCHLORIDE
ELLIOTTS B SOLUTION	CALCIUM CHLORIDE; DEXTROSE; MAGNESIUM SULFATE; POTASSIUM CHLORIDE; SODIUM BICARBONATE; SODIUM CHLORIDE; SODIUM PHOSPHATE, DIBASIC, HEPTAHYDRATE
COTAZYM	PANCRELIPASE (AMYLASE;LIPASE;PROTEASE)
TARKA	TRANDOLAPRIL; VERAPAMIL HYDROCHLORIDE
IMODIUM MULTI-SYMPTOM RELIEF	LOPERAMIDE HYDROCHLORIDE; SIMETHICONE
ARTHROTEC	DICLOFENAC SODIUM; MISOPROSTOL
BETOPTIC PILO	BETAXOLOL HYDROCHLORIDE; PILOCARPINE HYDROCHLORIDE
AMMONUL	SODIUM BENZOATE; SODIUM PHENYLACETATE
LEXXEL	ENALAPRIL MALEATE; FELODIPINE
CLINIMIX E 2.75/5 SULFITE FREE W/ ELECT IN DEXTROSE 5% W/ CALCIUM IN PLASTIC CONTAINER	AMINO ACIDS; CALCIUM CHLORIDE; DEXTROSE; MAGNESIUM CHLORIDE; POTASSIUM PHOSPHATE, DIBASIC; SODIUM ACETATE; SODIUM CHLORIDE
CLINIMIX E 2.75/10 SULFITE FREE W/ ELECT IN DEXTROSE 10% W/ CALCIUM IN PLASTIC CONTAINER	AMINO ACIDS; CALCIUM CHLORIDE; DEXTROSE; MAGNESIUM CHLORIDE; POTASSIUM PHOSPHATE, DIBASIC; SODIUM ACETATE; SODIUM CHLORIDE
CLINIMIX E 2.75/25 SULFITE FREE W/ ELECT IN DEXTROSE 25% W/ CALCIUM IN PLASTIC CONTAINER	AMINO ACIDS; CALCIUM CHLORIDE; DEXTROSE; MAGNESIUM CHLORIDE; POTASSIUM PHOSPHATE, DIBASIC; SODIUM ACETATE; SODIUM CHLORIDE
CLINIMIX E 4.25/5 SULFITE FREE W/ ELECT IN DEXTROSE 5% W/ CALCIUM IN PLASTIC CONTAINER	AMINO ACIDS; CALCIUM CHLORIDE; DEXTROSE; MAGNESIUM CHLORIDE; POTASSIUM PHOSPHATE, DIBASIC; SODIUM ACETATE; SODIUM CHLORIDE
CLINIMIX E 4.25/10 SULFITE FREE W/ ELECT IN DEXTROSE 10% W/ CALCIUM IN PLASTIC CONTAINER	AMINO ACIDS; CALCIUM CHLORIDE; DEXTROSE; MAGNESIUM CHLORIDE; POTASSIUM PHOSPHATE, DIBASIC; SODIUM ACETATE; SODIUM CHLORIDE
CLINIMIX E 4.25/20 SULFITE FREE W/ ELECT IN DEXTROSE 20% W/ CALCIUM IN PLASTIC CONTAINER	AMINO ACIDS; CALCIUM CHLORIDE; DEXTROSE; MAGNESIUM CHLORIDE; POTASSIUM PHOSPHATE, DIBASIC; SODIUM ACETATE; SODIUM CHLORIDE
CLINIMIX E 4.25/25 SULFITE FREE W/ ELECT IN DEXTROSE 25% W/ CALCIUM IN PLASTIC CONTAINER	AMINO ACIDS; CALCIUM CHLORIDE; DEXTROSE; MAGNESIUM CHLORIDE; POTASSIUM PHOSPHATE, DIBASIC; SODIUM ACETATE; SODIUM CHLORIDE
CLINIMIX E 5/10 SULFITE FREE W/ ELECT IN DEXTROSE 10% W/ CALCIUM IN PLASTIC CONTAINER	AMINO ACIDS; CALCIUM CHLORIDE; DEXTROSE; MAGNESIUM CHLORIDE; POTASSIUM PHOSPHATE, DIBASIC; SODIUM ACETATE; SODIUM CHLORIDE
CLINIMIX E 5/15 SULFITE FREE W/ ELECT IN DEXTROSE 15% W/ CALCIUM IN PLASTIC CONTAINER	AMINO ACIDS; CALCIUM CHLORIDE; DEXTROSE; MAGNESIUM CHLORIDE; POTASSIUM PHOSPHATE, DIBASIC; SODIUM ACETATE; SODIUM CHLORIDE
CLINIMIX E 5/20 SULFITE FREE W/ ELECT IN 20% DEXTROSE W/ CALCIUM IN PLASTIC CONTAINER	AMINO ACIDS; CALCIUM CHLORIDE; DEXTROSE; MAGNESIUM CHLORIDE; POTASSIUM PHOSPHATE, DIBASIC; SODIUM ACETATE; SODIUM CHLORIDE
CLINIMIX E 5/25 SULFITE FREE W/ ELECT IN DEXTROSE 25% W/ CALCIUM IN PLASTIC CONTAINER	AMINO ACIDS; CALCIUM CHLORIDE; DEXTROSE; MAGNESIUM CHLORIDE; POTASSIUM PHOSPHATE, DIBASIC; SODIUM ACETATE; SODIUM CHLORIDE
CLINIMIX E 5/35 SULFITE FREE W/ ELECT IN DEXTROSE 35% W/ CALCIUM IN PLASTIC CONTAINER	AMINO ACIDS; CALCIUM CHLORIDE; DEXTROSE; MAGNESIUM CHLORIDE; POTASSIUM PHOSPHATE, DIBASIC; SODIUM ACETATE; SODIUM CHLORIDE
ALESSE	ETHINYL ESTRADIOL; LEVONORGESTREL
MIRCETTE	DESOGESTREL; ETHINYL ESTRADIOL
VICOPROFEN	HYDROCODONE BITARTRATE; IBUPROFEN
CREON	PANCRELIPASE (AMYLASE;LIPASE;PROTEASE)
BIDIL	HYDRALAZINE HYDROCHLORIDE; ISOSORBIDE DINITRATE
UNIRETIC	HYDROCHLOROTHIAZIDE; MOEXIPRIL HYDROCHLORIDE
SUBOXONE	BUPRENORPHINE HYDROCHLORIDE; NALOXONE HYDROCHLORIDE
CLINIMIX 2.75/5 SULFITE FREE IN DEXTROSE 5% IN PLASTIC CONTAINER	AMINO ACIDS; DEXTROSE
CLINIMIX 2.75/10 SULFITE FREE IN DEXTROSE 10% IN PLASTIC CONTAINER	AMINO ACIDS; DEXTROSE
CLINIMIX 2.75/25 SULFITE FREE IN DEXTROSE 25% IN PLASTIC CONTAINER	AMINO ACIDS; DEXTROSE
CLINIMIX 4.25/5 SULFITE FREE IN DEXTROSE 5% IN PLASTIC CONTAINER	AMINO ACIDS; DEXTROSE
CLINIMIX 4.25/10 SULFITE FREE IN DEXTROSE 10% IN PLASTIC CONTAINER	AMINO ACIDS; DEXTROSE
CLINIMIX 4.25/20 SULFITE FREE IN DEXTROSE 20% IN PLASTIC CONTAINER	AMINO ACIDS; DEXTROSE
CLINIMIX 4.25/25 SULFITE FREE IN DEXTROSE 25% IN PLASTIC CONTAINER	AMINO ACIDS; DEXTROSE
CLINIMIX 5/10 SULFITE FREE IN DEXTROSE 10% IN PLASTIC CONTAINER	AMINO ACIDS; DEXTROSE
CLINIMIX 5/15 SULFITE FREE IN DEXTROSE 15% IN PLASTIC CONTAINER	AMINO ACIDS; DEXTROSE
CLINIMIX 5/20 SULFITE FREE IN DEXTROSE 20% IN PLASTIC CONTAINER	AMINO ACIDS; DEXTROSE
CLINIMIX 5/25 SULFITE FREE IN DEXTROSE 25% IN PLASTIC CONTAINER	AMINO ACIDS; DEXTROSE
CLINIMIX 5/35 SULFITE FREE IN DEXTROSE 35% IN PLASTIC CONTAINER	AMINO ACIDS; DEXTROSE
BSS	CALCIUM CHLORIDE; MAGNESIUM CHLORIDE; POTASSIUM CHLORIDE; SODIUM ACETATE; SODIUM CHLORIDE; SODIUM CITRATE
AVALIDE	HYDROCHLOROTHIAZIDE; IRBESARTAN
ALLEGRA-D 12 HOUR ALLERGY AND CONGESTION	FEXOFENADINE HYDROCHLORIDE; PSEUDOEPHEDRINE HYDROCHLORIDE
EXCEDRIN (MIGRAINE)	ACETAMINOPHEN; ASPIRIN; CAFFEINE
CIPRO HC	CIPROFLOXACIN HYDROCHLORIDE; HYDROCORTISONE
DIOVAN HCT	HYDROCHLOROTHIAZIDE; VALSARTAN
CHLORAPREP ONE-STEP	CHLORHEXIDINE GLUCONATE; ISOPROPYL ALCOHOL
CHLORAPREP WITH TINT	CHLORHEXIDINE GLUCONATE; ISOPROPYL ALCOHOL
CHLORAPREP ONE-STEP FREPP	CHLORHEXIDINE GLUCONATE; ISOPROPYL ALCOHOL
COMBIVIR	LAMIVUDINE; ZIDOVUDINE
LEVLITE	ETHINYL ESTRADIOL; LEVONORGESTREL
COSOPT	DORZOLAMIDE HYDROCHLORIDE; TIMOLOL MALEATE
COMBIPATCH	ESTRADIOL; NORETHINDRONE ACETATE
LUNELLE	ESTRADIOL CYPIONATE; MEDROXYPROGESTERONE ACETATE
AGGRENOX	ASPIRIN; DIPYRIDAMOLE
ACTIVELLA	ESTRADIOL; NORETHINDRONE ACETATE
SOLAGE	MEQUINOL; TRETINOIN
PREVEN EMERGENCY CONTRACEPTIVE KIT	ETHINYL ESTRADIOL; LEVONORGESTREL
DUONEB	ALBUTEROL SULFATE; IPRATROPIUM BROMIDE
PEPCID COMPLETE	CALCIUM CARBONATE; FAMOTIDINE; MAGNESIUM HYDROXIDE
SEPTOCAINE	ARTICAINE HYDROCHLORIDE; EPINEPHRINE BITARTRATE
HUMALOG MIX 75/25	INSULIN LISPRO PROTAMINE RECOMBINANT; INSULIN LISPRO RECOMBINANT
HUMALOG MIX 75/25 KWIKPEN	INSULIN LISPRO PROTAMINE RECOMBINANT; INSULIN LISPRO RECOMBINANT
HUMALOG MIX 75/25 PEN	INSULIN LISPRO PROTAMINE RECOMBINANT; INSULIN LISPRO RECOMBINANT
HUMALOG MIX 50/50	INSULIN LISPRO PROTAMINE RECOMBINANT; INSULIN LISPRO RECOMBINANT
HUMALOG MIX 50/50 KWIKPEN	INSULIN LISPRO PROTAMINE RECOMBINANT; INSULIN LISPRO RECOMBINANT
HUMALOG MIX 50/50 PEN	INSULIN LISPRO PROTAMINE RECOMBINANT; INSULIN LISPRO RECOMBINANT
VUSION	MICONAZOLE NITRATE; PETROLATUM, WHITE; ZINC OXIDE
PREFEST	ESTRADIOL; NORGESTIMATE
RID MOUSSE	PIPERONYL BUTOXIDE; PYRETHRINS
REPRONEX	MENOTROPINS (FSH;LH)
FEMHRT	ETHINYL ESTRADIOL; NORETHINDRONE ACETATE
AVAGARD	ALCOHOL; CHLORHEXIDINE GLUCONATE
ALEVE-D SINUS & COLD	NAPROXEN SODIUM; PSEUDOEPHEDRINE HYDROCHLORIDE
ADVAIR DISKUS 100/50	FLUTICASONE PROPIONATE; SALMETEROL XINAFOATE
ADVAIR DISKUS 250/50	FLUTICASONE PROPIONATE; SALMETEROL XINAFOATE
ADVAIR DISKUS 500/50	FLUTICASONE PROPIONATE; SALMETEROL XINAFOATE
MALARONE	ATOVAQUONE; PROGUANIL HYDROCHLORIDE
MALARONE PEDIATRIC	ATOVAQUONE; PROGUANIL HYDROCHLORIDE
TAVIST ALLERGY/SINUS/HEADACHE	ACETAMINOPHEN; CLEMASTINE FUMARATE; PSEUDOEPHEDRINE HYDROCHLORIDE
SKIN EXPOSURE REDUCTION PASTE AGAINST CHEMICAL WARFARE AGENTS	PERFLUOROPOLYMETHYLISOPROPYL ETHER; POLYTETRAFLUOROETHYLENE
CYCLESSA	DESOGESTREL; ETHINYL ESTRADIOL
ATACAND HCT	CANDESARTAN CILEXETIL; HYDROCHLOROTHIAZIDE
VISICOL	SODIUM PHOSPHATE, DIBASIC ANHYDROUS; SODIUM PHOSPHATE, MONOBASIC, MONOHYDRATE
YASMIN	DROSPIRENONE; ETHINYL ESTRADIOL
SULFAMETHOXAZOLE AND TRIMETHOPRIM AND PHENAZOPYRIDINE HYDROCHLORIDE	PHENAZOPYRIDINE HYDROCHLORIDE; SULFAMETHOXAZOLE; TRIMETHOPRIM
TRI-LUMA	FLUOCINOLONE ACETONIDE; HYDROQUINONE; TRETINOIN
ULTRACET	ACETAMINOPHEN; TRAMADOL HYDROCHLORIDE
CHILDREN'S MOTRIN COLD	IBUPROFEN; PSEUDOEPHEDRINE HYDROCHLORIDE
ZYRTEC-D 12 HOUR	CETIRIZINE HYDROCHLORIDE; PSEUDOEPHEDRINE HYDROCHLORIDE
MICARDIS HCT	HYDROCHLOROTHIAZIDE; TELMISARTAN
INFUVITE ADULT	ALPHA-TOCOPHEROL ACETATE; ASCORBIC ACID; BIOTIN; CHOLECALCIFEROL; CYANOCOBALAMIN; DEXPANTHENOL; FOLIC ACID; NIACINAMIDE; PYRIDOXINE HYDROCHLORIDE; RIBOFLAVIN 5'-PHOSPHATE SODIUM; THIAMINE HYDROCHLORIDE; VITAMIN A PALMITATE; VITAMIN K
NOVOLOG MIX 70/30	INSULIN ASPART PROTAMINE RECOMBINANT; INSULIN ASPART RECOMBINANT
NOVOLOG MIX 70/30 PENFILL	INSULIN ASPART PROTAMINE RECOMBINANT; INSULIN ASPART RECOMBINANT
NOVOLOG MIX 70/30 FLEXPEN	INSULIN ASPART PROTAMINE RECOMBINANT; INSULIN ASPART RECOMBINANT
ATNAA	ATROPINE; PRALIDOXIME CHLORIDE
GLUCOVANCE	GLYBURIDE; METFORMIN HYDROCHLORIDE
ORTHO EVRA	ETHINYL ESTRADIOL; NORELGESTROMIN
NUVARING	ETHINYL ESTRADIOL; ETONOGESTREL
IMAGENT	DIMYRISTOYL LECITHIN; PERFLEXANE
TRIZIVIR	ABACAVIR SULFATE; LAMIVUDINE; ZIDOVUDINE
KALETRA	LOPINAVIR; RITONAVIR
ORTHO TRI-CYCLEN LO	ETHINYL ESTRADIOL; NORGESTIMATE
ADVAIR HFA	FLUTICASONE PROPIONATE; SALMETEROL XINAFOATE
CLIMARA PRO	ESTRADIOL; LEVONORGESTREL
INFUVITE PEDIATRIC	ASCORBIC ACID; BIOTIN; CHOLECALCIFEROL; CYANOCOBALAMIN; DEXPANTHENOL; FOLIC ACID; NIACINAMIDE; PYRIDOXINE; RIBOFLAVIN; THIAMINE; TOCOPHEROL ACETATE; VITAMIN A; VITAMIN K
TEVETEN HCT	EPROSARTAN MESYLATE; HYDROCHLOROTHIAZIDE
ADDERALL XR 10	AMPHETAMINE ASPARTATE; AMPHETAMINE SULFATE; DEXTROAMPHETAMINE SACCHARATE; DEXTROAMPHETAMINE SULFATE
ADDERALL XR 20	AMPHETAMINE ASPARTATE; AMPHETAMINE SULFATE; DEXTROAMPHETAMINE SACCHARATE; DEXTROAMPHETAMINE SULFATE
ADDERALL XR 30	AMPHETAMINE ASPARTATE; AMPHETAMINE SULFATE; DEXTROAMPHETAMINE SACCHARATE; DEXTROAMPHETAMINE SULFATE
ADDERALL XR 25	AMPHETAMINE ASPARTATE; AMPHETAMINE SULFATE; DEXTROAMPHETAMINE SACCHARATE; DEXTROAMPHETAMINE SULFATE
ADDERALL XR 5	AMPHETAMINE ASPARTATE; AMPHETAMINE SULFATE; DEXTROAMPHETAMINE SACCHARATE; DEXTROAMPHETAMINE SULFATE
ADDERALL XR 15	AMPHETAMINE ASPARTATE; AMPHETAMINE SULFATE; DEXTROAMPHETAMINE SACCHARATE; DEXTROAMPHETAMINE SULFATE
CLARINEX-D 12 HOUR	DESLORATADINE; PSEUDOEPHEDRINE SULFATE
IDKIT:HP	CITRIC ACID; UREA C-13
ANGELIQ	DROSPIRENONE; ESTRADIOL
CODEPREX	CHLORPHENIRAMINE POLISTIREX; CODEINE POLISTIREX
CHILDREN'S ADVIL COLD	IBUPROFEN; PSEUDOEPHEDRINE HYDROCHLORIDE
COMBUNOX	IBUPROFEN; OXYCODONE HYDROCHLORIDE
XYLOCAINE DENTAL WITH EPINEPHRINE	EPINEPHRINE; LIDOCAINE HYDROCHLORIDE
CITANEST FORTE DENTAL	EPINEPHRINE BITARTRATE; PRILOCAINE HYDROCHLORIDE
PRAVIGARD PAC (COPACKAGED)	ASPIRIN; PRAVASTATIN SODIUM
ADVIL PM	DIPHENHYDRAMINE CITRATE; IBUPROFEN
COMBIGAN	BRIMONIDINE TARTRATE; TIMOLOL MALEATE
AVANDAMET	METFORMIN HYDROCHLORIDE; ROSIGLITAZONE MALEATE
ADVIL ALLERGY SINUS	CHLORPHENIRAMINE MALEATE; IBUPROFEN; PSEUDOEPHEDRINE HYDROCHLORIDE
ORAQIX	LIDOCAINE; PRILOCAINE
METAGLIP	GLIPIZIDE; METFORMIN HYDROCHLORIDE
ANTHELIOS 20	AVOBENZONE; ECAMSULE; OCTOCRYLENE; TITANIUM DIOXIDE
CIPRO XR	CIPROFLOXACIN; CIPROFLOXACIN HYDROCHLORIDE
STALEVO 50	CARBIDOPA; ENTACAPONE; LEVODOPA
STALEVO 100	CARBIDOPA; ENTACAPONE; LEVODOPA
STALEVO 150	CARBIDOPA; ENTACAPONE; LEVODOPA
STALEVO 200	CARBIDOPA; ENTACAPONE; LEVODOPA
STALEVO 75	CARBIDOPA; ENTACAPONE; LEVODOPA
STALEVO 125	CARBIDOPA; ENTACAPONE; LEVODOPA
LIDOCAINE HYDROCHLORIDE AND EPINEPHRINE	EPINEPHRINE; LIDOCAINE HYDROCHLORIDE
FEMCON FE	ETHINYL ESTRADIOL; NORETHINDRONE
DUOCAINE	BUPIVACAINE HYDROCHLORIDE; LIDOCAINE HYDROCHLORIDE
CAPITAL SOLEIL 15	AVOBENZONE; ECAMSULE; OCTOCRYLENE
ANTHELIOS SX	AVOBENZONE; ECAMSULE; OCTOCRYLENE
LIDOSITE TOPICAL SYSTEM KIT	EPINEPHRINE; LIDOCAINE HYDROCHLORIDE
PREVACID NAPRAPAC 250 (COPACKAGED)	LANSOPRAZOLE; NAPROXEN
PREVACID NAPRAPAC 375 (COPACKAGED)	LANSOPRAZOLE; NAPROXEN
PREVACID NAPRAPAC 500 (COPACKAGED)	LANSOPRAZOLE; NAPROXEN
SYMBYAX	FLUOXETINE HYDROCHLORIDE; OLANZAPINE
PREVANTICS SWAB	CHLORHEXIDINE GLUCONATE; ISOPROPYL ALCOHOL
PREVANTICS SWABSTICK	CHLORHEXIDINE GLUCONATE; ISOPROPYL ALCOHOL
PREVANTICS MAXI SWABSTICK	CHLORHEXIDINE GLUCONATE; ISOPROPYL ALCOHOL
BENICAR HCT	HYDROCHLOROTHIAZIDE; OLMESARTAN MEDOXOMIL
CIPRODEX	CIPROFLOXACIN; DEXAMETHASONE
CADUET	AMLODIPINE BESYLATE; ATORVASTATIN CALCIUM
SEASONALE	ETHINYL ESTRADIOL; LEVONORGESTREL
HALFLYTELY	BISACODYL; POLYETHYLENE GLYCOL 3350; POTASSIUM CHLORIDE; SODIUM BICARBONATE; SODIUM CHLORIDE
CHLORAPREP ONE-STEP SEPP	CHLORHEXIDINE GLUCONATE; ISOPROPYL ALCOHOL
CHLORAPREP SINGLE SWABSTICK	CHLORHEXIDINE GLUCONATE; ISOPROPYL ALCOHOL
CHLORAPREP TRIPLE SWABSTICK	CHLORHEXIDINE GLUCONATE; ISOPROPYL ALCOHOL
MUCINEX D	GUAIFENESIN; PSEUDOEPHEDRINE HYDROCHLORIDE
DURAPREP	IODINE POVACRYLEX; ISOPROPYL ALCOHOL
CHILDREN'S ADVIL ALLERGY SINUS	CHLORPHENIRAMINE MALEATE; IBUPROFEN; PSEUDOEPHEDRINE HYDROCHLORIDE
CLARINEX D 24 HOUR	DESLORATADINE; PSEUDOEPHEDRINE SULFATE
MUCINEX DM	DEXTROMETHORPHAN HYDROBROMIDE; GUAIFENESIN
SYNERA	LIDOCAINE; TETRACAINE
M.V.I. ADULT	ASCORBIC ACID; BIOTIN; CYANOCOBALAMIN; DEXPANTHENOL; ERGOCALCIFEROL; FOLIC ACID; NIACINAMIDE; PYRIDOXINE HYDROCHLORIDE; RIBOFLAVIN 5'-PHOSPHATE SODIUM; THIAMINE HYDROCHLORIDE; VITAMIN A; VITAMIN E; VITAMIN K
ZEGERID	MAGNESIUM HYDROXIDE; OMEPRAZOLE; SODIUM BICARBONATE
M.V.I. ADULT (PHARMACY BULK PACKAGE)	ASCORBIC ACID; BIOTIN; CYANOCOBALAMIN; DEXPANTHENOL; ERGOCALCIFEROL; FOLIC ACID; NIACINAMIDE; PYRIDOXINE HYDROCHLORIDE; RIBOFLAVIN 5'-PHOSPHATE SODIUM; THIAMINE HYDROCHLORIDE; VITAMIN A; VITAMIN E; VITAMIN K
INFUVITE PEDIATRIC (PHARMACY BULK PACKAGE)	ASCORBIC ACID; BIOTIN; CHOLECALCIFEROL; CYANOCOBALAMIN; DEXPANTHENOL; FOLIC ACID; NIACINAMIDE; PYRIDOXINE; RIBOFLAVIN; THIAMINE; TOCOPHEROL ACETATE; VITAMIN A; VITAMIN K
EPZICOM	ABACAVIR;LAMIVUDINE
MENOPUR	MENOTROPINS (FSH;LH)
YAZ	DROSPIRENONE; ETHINYL ESTRADIOL
VYTORIN	EZETIMIBE; SIMVASTATIN
ORTHO TRI-CYCLEN 21	ETHINYL ESTRADIOL; NORGESTIMATE
ORTHO TRI-CYCLEN 28	ETHINYL ESTRADIOL; NORGESTIMATE
AVANDARYL	GLIMEPIRIDE; ROSIGLITAZONE MALEATE
PRISMASOL BK 0/3.5 IN PLASTIC CONTAINER	CALCIUM CHLORIDE; DEXTROSE; LACTIC ACID; MAGNESIUM CHLORIDE; POTASSIUM CHLORIDE; SODIUM BICARBONATE; SODIUM CHLORIDE
PRISMASOL BGK 2/0 IN PLASTIC CONTAINER	CALCIUM CHLORIDE; DEXTROSE; LACTIC ACID; MAGNESIUM CHLORIDE; POTASSIUM CHLORIDE; SODIUM BICARBONATE; SODIUM CHLORIDE
PRISMASOL BGK 2/3.5 IN PLASTIC CONTAINER	CALCIUM CHLORIDE; DEXTROSE; LACTIC ACID; MAGNESIUM CHLORIDE; POTASSIUM CHLORIDE; SODIUM BICARBONATE; SODIUM CHLORIDE
PRISMASOL BGK 4/2.5 IN PLASTIC CONTAINER	CALCIUM CHLORIDE; DEXTROSE; LACTIC ACID; MAGNESIUM CHLORIDE; POTASSIUM CHLORIDE; SODIUM BICARBONATE; SODIUM CHLORIDE
PRISMASOL BGK 4/0 IN PLASTIC CONTAINER	CALCIUM CHLORIDE; DEXTROSE; LACTIC ACID; MAGNESIUM CHLORIDE; POTASSIUM CHLORIDE; SODIUM BICARBONATE; SODIUM CHLORIDE
PRISMASOL BGK 0/2.5 IN PLASTIC CONTAINER	CALCIUM CHLORIDE; DEXTROSE; LACTIC ACID; MAGNESIUM CHLORIDE; POTASSIUM CHLORIDE; SODIUM BICARBONATE; SODIUM CHLORIDE
PRISMASOL BK 0/0 IN PLASTIC CONTAINER	CALCIUM CHLORIDE; DEXTROSE; LACTIC ACID; MAGNESIUM CHLORIDE; POTASSIUM CHLORIDE; SODIUM BICARBONATE; SODIUM CHLORIDE
PRISMASOL BGK 4/3.5 IN PLASTIC CONTAINER	CALCIUM CHLORIDE; DEXTROSE; LACTIC ACID; MAGNESIUM CHLORIDE; POTASSIUM CHLORIDE; SODIUM BICARBONATE; SODIUM CHLORIDE
PRISMASOL BK 4/2.5 IN PLASTIC CONTAINER	CALCIUM CHLORIDE; DEXTROSE; LACTIC ACID; MAGNESIUM CHLORIDE; POTASSIUM CHLORIDE; SODIUM BICARBONATE; SODIUM CHLORIDE
PRISMASOL B22GK 2/0 IN PLASTIC CONTAINER	CALCIUM CHLORIDE; DEXTROSE; LACTIC ACID; MAGNESIUM CHLORIDE; POTASSIUM CHLORIDE; SODIUM BICARBONATE; SODIUM CHLORIDE
PRISMASOL B22GK 4/0 IN PLASTIC CONTAINER	CALCIUM CHLORIDE; DEXTROSE; LACTIC ACID; MAGNESIUM CHLORIDE; POTASSIUM CHLORIDE; SODIUM BICARBONATE; SODIUM CHLORIDE
PRISMASOL B22GK 2/2.5 IN PLASTIC CONTAINER	CALCIUM CHLORIDE; DEXTROSE; LACTIC ACID; MAGNESIUM CHLORIDE; POTASSIUM CHLORIDE; SODIUM BICARBONATE; SODIUM CHLORIDE
PRISMASOL B22GK 4/2.5 IN PLASTIC CONTAINER	CALCIUM CHLORIDE; DEXTROSE; LACTIC ACID; MAGNESIUM CHLORIDE; POTASSIUM CHLORIDE; SODIUM BICARBONATE; SODIUM CHLORIDE
PRISMASOL BK 0/0/1.2 IN PLASTIC CONTAINER	CALCIUM CHLORIDE; DEXTROSE; LACTIC ACID; MAGNESIUM CHLORIDE; POTASSIUM CHLORIDE; SODIUM BICARBONATE; SODIUM CHLORIDE
PRISMASOL BGK 4/0/1.2 IN PLASTIC CONTAINER	CALCIUM CHLORIDE; DEXTROSE; LACTIC ACID; MAGNESIUM CHLORIDE; POTASSIUM CHLORIDE; SODIUM BICARBONATE; SODIUM CHLORIDE
ALLEGRA-D 24 HOUR ALLERGY AND CONGESTION	FEXOFENADINE HYDROCHLORIDE; PSEUDOEPHEDRINE HYDROCHLORIDE
AMLODIPINE MALEATE; BENAZEPRIL HYDROCHLORIDE	AMLODIPINE MALEATE; BENAZEPRIL HYDROCHLORIDE
PLIAGLIS	LIDOCAINE; TETRACAINE
COMBIVENT RESPIMAT	ALBUTEROL SULFATE; IPRATROPIUM BROMIDE
TRUVADA	EMTRICITABINE; TENOFOVIR DISOPROXIL FUMARATE
FOSAMAX PLUS D	ALENDRONATE SODIUM; CHOLECALCIFEROL
NOVOLOG MIX 50/50	INSULIN ASPART PROTAMINE RECOMBINANT; INSULIN ASPART RECOMBINANT
ACTONEL WITH CALCIUM (COPACKAGED)	CALCIUM CARBONATE; RISEDRONATE SODIUM
LEVOFLOXACIN	LEVOFLOXACIN; SODIUM CHLORIDE
STAVUDINE; LAMIVUDINE; NEVIRAPINE	STAVUDINE; LAMIVUDINE; NEVIRAPINE
STAVUDINE; LAMIVUDINE	STAVUDINE; LAMIVUDINE
SEASONIQUE	ETHINYL ESTRADIOL; LEVONORGESTREL
ACTOPLUS MET	METFORMIN HYDROCHLORIDE; PIOGLITAZONE HYDROCHLORIDE
TACLONEX	BETAMETHASONE DIPROPIONATE; CALCIPOTRIENE HYDRATE
STAVUDINE; LAMIVUDINE W/NEVIRAPINE	STAVUDINE; LAMIVUDINE; NEVIRAPINE
LYBREL	ETHINYL ESTRADIOL; LEVONORGESTREL
LOESTRIN 24 FE	ETHINYL ESTRADIOL; NORETHINDRONE ACETATE
DICLEGIS	DOXYLAMINE SUCCINATE; PYRIDOXINE HYDROCHLORIDE
NUEDEXTA	DEXTROMETHORPHAN HYDROBROMIDE; QUINIDINE SULFATE
MOVIPREP	ASCORBIC ACID; POLYETHYLENE GLYCOL 3350; POTASSIUM CHLORIDE; SODIUM ASCORBATE; SODIUM CHLORIDE; SODIUM SULFATE
OSMOPREP	SODIUM PHOSPHATE, DIBASIC, ANHYDROUS; SODIUM PHOSPHATE, MONOBASIC, MONOHYDRATE
NORMOCARB HF 25	MAGNESIUM CHLORIDE; SODIUM BICARBONATE; SODIUM CHLORIDE
NORMOCARB HF 35	MAGNESIUM CHLORIDE; SODIUM BICARBONATE; SODIUM CHLORIDE
DUETACT	GLIMEPIRIDE; PIOGLITAZONE HYDROCHLORIDE
TREXIMET	NAPROXEN SODIUM; SUMATRIPTAN SUCCINATE
SYMBICORT	BUDESONIDE; FORMOTEROL FUMARATE DIHYDRATE
ATRIPLA	EFAVIRENZ; EMTRICITABINE; TENOFOVIR DISOPROXIL FUMARATE
Lamivudine, Zidovudine, Nevirapine Tabs 150mg/300mg/200mg	LAMIVUDINE; ZIDOVUDINE; NEVIRAPINE
LAMIVUDINE; ZIDOVUDINE	LAMIVUDINE; ZIDOVUDINE
LAMIVUDINE; ZIDOVUDINE; ABACAVIR	LAMIVUDINE; ZIDOVUDINE; ABACAVIR
DUTOPROL	HYDROCHLOROTHIAZIDE; METOPROLOL SUCCINATE
LAMIVUDINE; STAVUDINE; NEVIRAPINE	LAMIVUDINE; STAVUDINE; NEVIRAPINE
LAMIVUDINE; ZIDOVUDINE; NEVIRAPINE	LAMIVUDINE; ZIDOVUDINE; NEVIRAPINE
LAMIVUDINE; STAVUDINE	LAMIVUDINE; STAVUDINE
DUODOTE	ATROPINE; PRALIDOXIME CHLORIDE
Lamivudine/Zidovudine 150 mg/300 mg Tablets Co-packaged with Nevirapine 200 mg Tablets	LAMIVUDINE; ZIDOVUDINE; NEVIRAPINE
EXFORGE	AMLODIPINE BESYLATE; VALSARTAN
ANTHELIOS 40	AVOBENZONE; ECAMSULE; OCTOCRYLENE; TITANIUM DIOXIDE
LAMIVUDINE AND ZIDOVUDINE	LAMIVUDINE; ZIDOVUDINE
ACTOPLUS MET XR	METFORMIN HYDROCHLORIDE; PIOGLITAZONE HYDROCHLORIDE
SALONPAS	MENTHOL; METHYL SALICYLATE
JANUMET	METFORMIN HYDROCHLORIDE; SITAGLIPTIN PHOSPHATE
BUPIVACAINE HYDROCHLORIDE W/EPINEPHRINE	BUPIVACAINE HYDROCHLORIDE; EPINEPHRINE BITARTRATE
LAMIVUDINE; NEVIRAPINE; ZIDOVUDINE	LAMIVUDINE; NEVIRAPINE; ZIDOVUDINE
MYDAYIS	AMPHETAMINE ASPARTATE; AMPHETAMINE SULFATE; DEXTROAMPHETAMINE SACCHARATE; DEXTROAMPHETAMINE SULFATE
LAMIVUDINE; ZIDOVUDINE; EFAVIRENZ	LAMIVUDINE;ZIDOVUDINE;EFAVIRENZ
STAVUDINE; LAMIVUDINE; EFAVIRENZ	STAVUDINE; LAMIVUDINE; EFAVIRENZ
AZOR	AMLODIPINE BESYLATE; OLMESARTAN MEDOXOMIL
TEKTURNA HCT	ALISKIREN HEMIFUMARATE; HYDROCHLOROTHIAZIDE
ADVIL ALLERGY AND CONGESTION RELIEF	CHLORPHENIRAMINE MALEATE; IBUPROFEN; PHENYLEPHRINE HYDROCHLORIDE
ADVIL MULTI-SYMPTOM COLD & FLU	CHLORPHENIRAMINE MALEATE; IBUPROFEN; PHENYLEPHRINE HYDROCHLORIDE
CIMDUO	LAMIVUDINE; TENOFOVIR DISOPROXIL FUMARATE
SYMFI	EFAVIRENZ; LAMIVUDINE; TENOFOVIR DISOPROXIL FUMARATE
PERTZYE	PANCRELIPASE (AMYLASE;LIPASE;PROTEASE)
NAVSTEL	CALCIUM CHLORIDE; DEXTROSE; MAGNESIUM CHLORIDE; OXIGLUTATIONE; POTASSIUM CHLORIDE; SODIUM BICARBONATE; SODIUM CHLORIDE; SODIUM PHOSPHATE
ZENPEP	PANCRELIPASE (AMYLASE;LIPASE;PROTEASE)
VALTURNA	ALISKIREN HEMIFUMARATE; VALSARTAN
ULTRESA	PANCRELIPASE (AMYLASE;LIPASE;PROTEASE)
DUAVEE	BAZEDOXIFENE ACETATE; ESTROGENS, CONJUGATED
NATAZIA	DIENOGEST; ESTRADIOL VALERATE
LOSEASONIQUE	ETHINYL ESTRADIOL; LEVONORGESTREL
COARTEM	ARTEMETHER; LUMEFANTRINE
HYCOFENIX	GUAIFENESIN; HYDROCODONE BITARTRATE; PSEUDOEPHEDRINE HYDROCHLORIDE
ZEGERID OTC	OMEPRAZOLE; SODIUM BICARBONATE
ATAZANAVIR SULFATE AND RITONAVIR	ATAZANAVIR SULFATE; RITONAVIR
ABACAVIR SULFATE; LAMIVUDINE	ABACAVIR SULFATE;LAMIVUDINE
EXFORGE HCT	AMLODIPINE BESYLATE; HYDROCHLOROTHIAZIDE; VALSARTAN
EPIDUO	ADAPALENE; BENZOYL PEROXIDE
EMBEDA	MORPHINE SULFATE; NALTREXONE HYDROCHLORIDE
EFAVIRENZ, LAMIVUDINE AND TENOFOVIR DISOPROXIL FUMARATE	EFAVIRENZ; LAMIVUDINE; TENOFOVIR DISOPROXIL FUMARATE
LAMIVUDINE AND TENOFOVIR DISOPROXIL FUMARATE	LAMIVUDINE; TENOFOVIR DISOPROXIL FUMARATE
LAMIVUDINE, ZIDOVUDINE TABS 150MG/300MG CO-PACKAGED WITH NEVIRAPINE TABS 200MG	LAMIVUDINE; ZIDOVUDINE; NEVIRAPINE
SUPREP BOWEL PREP KIT	MAGNESIUM SULFATE; POTASSIUM SULFATE; SODIUM SULFATE
PRANDIMET	METFORMIN HYDROCHLORIDE; REPAGLINIDE
TWYNSTA	AMLODIPINE BESYLATE; TELMISARTAN
FLOWTUSS	GUAIFENESIN; HYDROCODONE BITARTRATE
OSENI	ALOGLIPTIN BENZOATE; PIOGLITAZONE HYDROCHLORIDE
XERESE	ACYCLOVIR; HYDROCORTISONE
ZUTRIPRO	CHLORPHENIRAMINE MALEATE; HYDROCODONE BITARTRATE; PSEUDOEPHEDRINE HYDROCHLORIDE
REZIRA	HYDROCODONE BITARTRATE; PSEUDOEPHEDRINE HYDROCHLORIDE
MAGNESIUM HYDROXIDE AND OMEPRAZOLE AND SODIUM BICARBONATE	MAGNESIUM HYDROXIDE; OMEPRAZOLE; SODIUM BICARBONATE
LAMIVUDINE/TENOFOVIR DISOPROXIL FUMARATE FDC TABS	LAMIVUDINE; TENOFOVIR
JALYN	DUTASTERIDE; TAMSULOSIN HYDROCHLORIDE
ORABLOC	ARTICAINE HYDROCHLORIDE; EPINEPHRINE BITARTRATE
LAMIVUDINE AND STAVUDINE	LAMIVUDINE; STAVUDINE
LO LOESTRIN FE	ETHINYL ESTRADIOL; NORETHINDRONE ACETATE
VIMOVO	ESOMEPRAZOLE MAGNESIUM; NAPROXEN
DULERA	FORMOTEROL FUMARATE; MOMETASONE FUROATE
DUEXIS	FAMOTIDINE; IBUPROFEN
PANCREAZE	PANCRELIPASE (AMYLASE;LIPASE;PROTEASE)
BEYAZ	DROSPIRENONE; ETHINYL ESTRADIOL; LEVOMEFOLATE CALCIUM
VIOKACE	PANCRELIPASE (AMYLASE;LIPASE;PROTEASE)
TEKAMLO	ALISKIREN HEMIFUMARATE; AMLODIPINE BESYLATE
ADVIL CONGESTION RELIEF	IBUPROFEN; PHENYLEPHRINE HYDROCHLORIDE
NORETHINDRONE AND ETHINYL ESTRADIOL AND FERROUS FUMARATE	ETHINYL ESTRADIOL; NORETHINDRONE
SAFYRAL	DROSPIRENONE; ETHINYL ESTRADIOL; LEVOMEFOLATE CALCIUM
QSYMIA	PHENTERMINE HYDROCHLORIDE; TOPIRAMATE
ROXILOX	ACETAMINOPHEN; OXYCODONE HYDROCHLORIDE
ACETIC ACID 2% IN AQUEOUS ALUMINUM ACETATE	ACETIC ACID, GLACIAL; ALUMINUM ACETATE
HYDROCODONE BITARTRATE AND ACETAMINOPHEN	ACETAMINOPHEN; HYDROCODONE BITARTRATE
ESGIC-PLUS	ACETAMINOPHEN; BUTALBITAL; CAFFEINE
HYDROCORTISONE AND ACETIC ACID	ACETIC ACID, GLACIAL; HYDROCORTISONE
ACETAMINOPHEN AND CODEINE PHOSPHATE	ACETAMINOPHEN; CODEINE PHOSPHATE
NORCO	ACETAMINOPHEN; HYDROCODONE BITARTRATE
LORTAB	ACETAMINOPHEN; HYDROCODONE BITARTRATE
OXYCODONE AND ACETAMINOPHEN	ACETAMINOPHEN; OXYCODONE HYDROCHLORIDE
ACETAMINOPHEN, CAFFEINE, AND DIHYDROCODEINE BITARTRATE	ACETAMINOPHEN; CAFFEINE; DIHYDROCODEINE BITARTRATE
CARISOPRODOL AND ASPIRIN	ASPIRIN; CARISOPRODOL
VICODIN HP	ACETAMINOPHEN; HYDROCODONE BITARTRATE
CARISOPRODOL, ASPIRIN AND CODEINE PHOSPHATE	ASPIRIN; CARISOPRODOL; CODEINE PHOSPHATE
PROPOXYPHENE HYDROCHLORIDE AND ACETAMINOPHEN	ACETAMINOPHEN; PROPOXYPHENE HYDROCHLORIDE
PROMETHAZINE HYDROCHLORIDE AND CODEINE PHOSPHATE	CODEINE PHOSPHATE; PROMETHAZINE HYDROCHLORIDE
OXYCODONE AND ASPIRIN	ASPIRIN; OXYCODONE HYDROCHLORIDE
BUTALBITAL, ACETAMINOPHEN AND CAFFEINE	ACETAMINOPHEN; BUTALBITAL; CAFFEINE
HYDROCODONE BITARTRATE AND HOMATROPINE METHYLBROMIDE	HOMATROPINE METHYLBROMIDE; HYDROCODONE BITARTRATE
ZYDONE	ACETAMINOPHEN; HYDROCODONE BITARTRATE
HOMATROPINE METHYLBROMIDE AND HYDROCODONE BITARTRATE	HOMATROPINE METHYLBROMIDE; HYDROCODONE BITARTRATE
PERCOCET	ACETAMINOPHEN; OXYCODONE HYDROCHLORIDE
DIPHENOXYLATE HYDROCHLORIDE AND ATROPINE SULFATE	ATROPINE SULFATE; DIPHENOXYLATE HYDROCHLORIDE
ANEXSIA 7.5/325	ACETAMINOPHEN; HYDROCODONE BITARTRATE
ANEXSIA 5/325	ACETAMINOPHEN; HYDROCODONE BITARTRATE
DEXTROAMP SACCHARATE, AMP ASPARTATE, DEXTROAMP SULFATE AND AMP SULFATE	AMPHETAMINE ASPARTATE; AMPHETAMINE SULFATE; DEXTROAMPHETAMINE SACCHARATE; DEXTROAMPHETAMINE SULFATE
CODRIX	ACETAMINOPHEN; CODEINE PHOSPHATE
ANEXSIA	ACETAMINOPHEN; HYDROCODONE BITARTRATE
ERGOTAMINE TARTRATE AND CAFFEINE	CAFFEINE; ERGOTAMINE TARTRATE
PROBENECID AND COLCHICINE	COLCHICINE; PROBENECID
PROMETHAZINE DM	DEXTROMETHORPHAN HYDROBROMIDE; PROMETHAZINE HYDROCHLORIDE
PROMETHAZINE WITH CODEINE	CODEINE PHOSPHATE; PROMETHAZINE HYDROCHLORIDE
PHENYLEPHRINE HYDROCHLORIDE AND PROMETHAZINE HYDROCHLORIDE	PHENYLEPHRINE HYDROCHLORIDE; PROMETHAZINE HYDROCHLORIDE
PROMETH HYDROCHLORIDE,PHENYLEPHRINE HYDROCHLORIDE W/CODEINE PHOSPHATE	CODEINE PHOSPHATE; PHENYLEPHRINE HYDROCHLORIDE; PROMETHAZINE HYDROCHLORIDE
PROMETHAZINE HYDROCHLORIDE, PHENYLEPHRINE HYDROCHLORIDE W/CODEINE PHOSPHATE	CODEINE PHOSPHATE; PHENYLEPHRINE HYDROCHLORIDE; PROMETHAZINE HYDROCHLORIDE
PROMETHAZINE HYDROCHLORIDE AND PHENYLEPHRINE HYDROCHLORIDE	PHENYLEPHRINE HYDROCHLORIDE; PROMETHAZINE HYDROCHLORIDE
MAXITROL	DEXAMETHASONE; NEOMYCIN SULFATE; POLYMYXIN B SULFATE
POLY-PRED	NEOMYCIN SULFATE; POLYMYXIN B SULFATE; PREDNISOLONE ACETATE
BICILLIN C-R	PENICILLIN G BENZATHINE; PENICILLIN G PROCAINE
BICILLIN C-R 900/300	PENICILLIN G BENZATHINE; PENICILLIN G PROCAINE
POLYSPORIN	BACITRACIN ZINC; POLYMYXIN B SULFATE
CORTISPORIN	HYDROCORTISONE; NEOMYCIN SULFATE; POLYMYXIN B SULFATE
NEOSPORIN	GRAMICIDIN; NEOMYCIN SULFATE; POLYMYXIN B SULFATE
OPHTHOCORT	CHLORAMPHENICOL; HYDROCORTISONE ACETATE; POLYMYXIN B SULFATE
CHLOROMYCETIN HYDROCORTISONE	CHLORAMPHENICOL; HYDROCORTISONE ACETATE
CHLOROMYXIN	CHLORAMPHENICOL; POLYMYXIN B SULFATE
NYSTAFORM	CLIOQUINOL; NYSTATIN
NEO-CORT-DOME	ACETIC ACID, GLACIAL; HYDROCORTISONE; NEOMYCIN SULFATE
ACHROMYCIN	PROCAINE HYDROCHLORIDE; TETRACYCLINE HYDROCHLORIDE
ELASE-CHLOROMYCETIN	CHLORAMPHENICOL; DESOXYRIBONUCLEASE; FIBRINOLYSIN
NEODECADRON	DEXAMETHASONE SODIUM PHOSPHATE; NEOMYCIN SULFATE
STATROL	NEOMYCIN SULFATE; POLYMYXIN B SULFATE
CORDRAN N	FLURANDRENOLIDE; NEOMYCIN SULFATE
COLY-MYCIN S	COLISTIN SULFATE; HYDROCORTISONE ACETATE; NEOMYCIN SULFATE; THONZONIUM BROMIDE
NEO-HYDELTRASOL	NEOMYCIN SULFATE; PREDNISOLONE SODIUM PHOSPHATE
POLYCILLIN-PRB	AMPICILLIN/AMPICILLIN TRIHYDRATE; PROBENECID
PRINCIPEN W/ PROBENECID	AMPICILLIN/AMPICILLIN TRIHYDRATE; PROBENECID
PEDIAZOLE	ERYTHROMYCIN ETHYLSUCCINATE; SULFISOXAZOLE ACETYL
BENZAMYCIN	BENZOYL PEROXIDE; ERYTHROMYCIN
AUGMENTIN '250'	AMOXICILLIN; CLAVULANATE POTASSIUM
AUGMENTIN '500'	AMOXICILLIN; CLAVULANATE POTASSIUM
POLYTRIM	POLYMYXIN B SULFATE; TRIMETHOPRIM SULFATE
AUGMENTIN '125'	AMOXICILLIN; CLAVULANATE POTASSIUM
ROCEPHIN KIT	CEFTRIAXONE SODIUM; LIDOCAINE
PRED-G	GENTAMICIN SULFATE; PREDNISOLONE ACETATE
PRIMAXIN	CILASTATIN SODIUM; IMIPENEM
TIMENTIN	CLAVULANATE POTASSIUM; TICARCILLIN DISODIUM
TOBRADEX	DEXAMETHASONE; TOBRAMYCIN
LANABIOTIC	BACITRACIN ZINC; LIDOCAINE; NEOMYCIN SULFATE; POLYMYXIN B SULFATE
ILOSONE SULFA	ERYTHROMYCIN ESTOLATE; SULFISOXAZOLE ACETYL
UNASYN	AMPICILLIN SODIUM; SULBACTAM SODIUM
TOBRASONE	FLUOROMETHOLONE ACETATE; TOBRAMYCIN
TIMENTIN IN PLASTIC CONTAINER	CLAVULANATE POTASSIUM; TICARCILLIN DISODIUM
ZOSYN	PIPERACILLIN SODIUM; TAZOBACTAM SODIUM
RIFATER	ISONIAZID; PYRAZINAMIDE; RIFAMPIN
HELIDAC	BISMUTH SUBSALICYLATE; METRONIDAZOLE; TETRACYCLINE HYDROCHLORIDE
AUGMENTIN '875'	AMOXICILLIN; CLAVULANATE POTASSIUM
AUGMENTIN '200'	AMOXICILLIN; CLAVULANATE POTASSIUM
AUGMENTIN '400'	AMOXICILLIN; CLAVULANATE POTASSIUM
DUAC	BENZOYL PEROXIDE; CLINDAMYCIN PHOSPHATE
SYNERCID	DALFOPRISTIN; QUINUPRISTIN
ZOSYN IN PLASTIC CONTAINER	PIPERACILLIN SODIUM; TAZOBACTAM SODIUM
AUGMENTIN ES-600	AMOXICILLIN; CLAVULANATE POTASSIUM
BENZACLIN	BENZOYL PEROXIDE; CLINDAMYCIN PHOSPHATE
PREVPAC	AMOXICILLIN; CLARITHROMYCIN; LANSOPRAZOLE
TROVAN/ZITHROMAX COMPLIANCE PAK	AZITHROMYCIN DIHYDRATE; TROVAFLOXACIN MESYLATE
AKTIPAK	BENZOYL PEROXIDE; ERYTHROMYCIN
AUGMENTIN XR	AMOXICILLIN; CLAVULANATE POTASSIUM
PYLERA	BISMUTH SUBCITRATE POTASSIUM; METRONIDAZOLE; TETRACYCLINE
ZIANA	CLINDAMYCIN PHOSPHATE; TRETINOIN
VELTIN	CLINDAMYCIN PHOSPHATE; TRETINOIN
ZYLET	LOTEPREDNOL ETABONATE; TOBRAMYCIN
TOBRADEX ST	DEXAMETHASONE; TOBRAMYCIN
ACANYA	BENZOYL PEROXIDE; CLINDAMYCIN PHOSPHATE
ONEXTON	BENZOYL PEROXIDE; CLINDAMYCIN PHOSPHATE
OMEPRAZOLE AND CLARITHROMYCIN AND AMOXICILLIN	AMOXICILLIN; CLARITHROMYCIN; OMEPRAZOLE
COR-OTICIN	HYDROCORTISONE ACETATE; NEOMYCIN SULFATE
TETRACYN	PROCAINE HYDROCHLORIDE; TETRACYCLINE HYDROCHLORIDE
NEO-POLYCIN	BACITRACIN ZINC; NEOMYCIN SULFATE; POLYMYXIN B SULFATE
TERRAMYCIN	LIDOCAINE HYDROCHLORIDE; OXYTETRACYCLINE
MYCOLOG-II	NYSTATIN; TRIAMCINOLONE ACETONIDE
NEO-CORTEF	HYDROCORTISONE ACETATE; NEOMYCIN SULFATE
NEO-MEDROL ACETATE	METHYLPREDNISOLONE ACETATE; NEOMYCIN SULFATE
CASPORYN HC	HYDROCORTISONE; NEOMYCIN SULFATE; POLYMYXIN B SULFATE
NEO-MEDROL	METHYLPREDNISOLONE; NEOMYCIN SULFATE
NEO-SYNALAR	FLUOCINOLONE ACETONIDE; NEOMYCIN SULFATE
NEOSPORIN G.U. IRRIGANT	NEOMYCIN SULFATE; POLYMYXIN B SULFATE
OTOCORT	HYDROCORTISONE; NEOMYCIN SULFATE; POLYMYXIN B SULFATE
BACITRACIN-NEOMYCIN-POLYMYXIN W/ HYDROCORTISONE ACETATE	BACITRACIN ZINC; HYDROCORTISONE ACETATE; NEOMYCIN SULFATE; POLYMYXIN B SULFATE
NEOMYCIN AND POLYMYXIN B SULFATES AND BACITRACIN ZINC	BACITRACIN ZINC; NEOMYCIN SULFATE; POLYMYXIN B SULFATE
TERRAMYCIN-POLYMYXIN	OXYTETRACYCLINE HYDROCHLORIDE; POLYMYXIN B SULFATE
TERRAMYCIN W/ POLYMYXIN B SULFATE	OXYTETRACYCLINE HYDROCHLORIDE; POLYMYXIN B SULFATE
TERRA-CORTRIL	HYDROCORTISONE ACETATE; OXYTETRACYCLINE HYDROCHLORIDE
NEO-DELTA-CORTEF	NEOMYCIN SULFATE; PREDNISOLONE ACETATE
MYCITRACIN	BACITRACIN; NEOMYCIN SULFATE; POLYMYXIN B SULFATE
CHLOROPTIC-P S.O.P.	CHLORAMPHENICOL; PREDNISOLONE
PYOCIDIN	HYDROCORTISONE; POLYMYXIN B SULFATE
PROBAMPACIN	AMPICILLIN/AMPICILLIN TRIHYDRATE; PROBENECID
OTOBIONE	HYDROCORTISONE; NEOMYCIN SULFATE; POLYMYXIN B SULFATE
TERRAMYCIN W/ POLYMYXIN	OXYTETRACYCLINE HYDROCHLORIDE; POLYMYXIN B SULFATE
RIFAMATE	ISONIAZID; RIFAMPIN
MYCO-TRIACET II	NYSTATIN; TRIAMCINOLONE ACETONIDE
BACITRACIN-NEOMYCIN-POLYMYXIN	BACITRACIN ZINC; NEOMYCIN SULFATE; POLYMYXIN B SULFATE
NYSTATIN AND TRIAMCINOLONE ACETONIDE	NYSTATIN; TRIAMCINOLONE ACETONIDE
OTOBIOTIC	HYDROCORTISONE; POLYMYXIN B SULFATE
MYKACET	NYSTATIN; TRIAMCINOLONE ACETONIDE
NEOMYCIN & POLYMYXIN B SULFATES & BACITRACIN ZINC & HYDROCORTISONE	BACITRACIN ZINC; HYDROCORTISONE; NEOMYCIN SULFATE; POLYMYXIN B SULFATE
NEOMYCIN SULFATE AND POLYMYXIN B SULFATE GRAMICIDIN	GRAMICIDIN; NEOMYCIN SULFATE; POLYMYXIN B SULFATE
BACITRACIN ZINC-NEOMYCIN SULFATE-POLYMYXIN B SULFATE	BACITRACIN ZINC; NEOMYCIN SULFATE; POLYMYXIN B SULFATE
ZINC BACITRACIN,NEOMYCIN SULFATE,POLYMYXIN B SULFATE & HYDROCORTISONE	BACITRACIN ZINC; HYDROCORTISONE; NEOMYCIN SULFATE; POLYMYXIN B SULFATE
NEOMYCIN SULFATE-POLYMYXIN B SULFATE-HYDROCORTISONE	HYDROCORTISONE; NEOMYCIN SULFATE; POLYMYXIN B SULFATE
OTICAIR	HYDROCORTISONE; NEOMYCIN SULFATE; POLYMYXIN B SULFATE
DEXASPORIN	DEXAMETHASONE; NEOMYCIN SULFATE; POLYMYXIN B SULFATE
NEOMYCIN AND POLYMYXIN B SULFATES AND HYDROCORTISONE	HYDROCORTISONE; NEOMYCIN SULFATE; POLYMYXIN B SULFATE
OCUMYCIN	BACITRACIN ZINC; POLYMYXIN B SULFATE
NEOMYCIN SULFATE-DEXAMETHASONE SODIUM PHOSPHATE	DEXAMETHASONE SODIUM PHOSPHATE; NEOMYCIN SULFATE
DEXACIDIN	DEXAMETHASONE; NEOMYCIN SULFATE; POLYMYXIN B SULFATE
NEOMYCIN SULFATE-TRIAMCINOLONE ACETONIDE	NEOMYCIN SULFATE; TRIAMCINOLONE ACETONIDE
NYSTATIN TRIAMCINOLONE ACETONIDE	NYSTATIN; TRIAMCINOLONE ACETONIDE
MYTREX F	NYSTATIN; TRIAMCINOLONE ACETONIDE
MYTREX A	NEOMYCIN SULFATE; TRIAMCINOLONE ACETONIDE
NYSTATIN-TRIAMCINOLONE ACETONIDE	NYSTATIN; TRIAMCINOLONE ACETONIDE
NEOMYCIN SULFATE, POLYMYXIN B SULFATE & HYDROCORTISONE	HYDROCORTISONE; NEOMYCIN SULFATE; POLYMYXIN B SULFATE
NEOMYCIN AND POLYMYXIN B SULFATE	NEOMYCIN SULFATE; POLYMYXIN B SULFATE
NEOMYCIN AND POLYMYXIN B SULFATES AND DEXAMETHASONE	DEXAMETHASONE; NEOMYCIN SULFATE; POLYMYXIN B SULFATE
ERYZOLE	ERYTHROMYCIN ETHYLSUCCINATE; SULFISOXAZOLE ACETYL
ERYTHROMYCIN ETHYLSUCCINATE AND SULFISOXAZOLE ACETYL	ERYTHROMYCIN ETHYLSUCCINATE; SULFISOXAZOLE ACETYL
NEOMYCIN AND POLYMYXIN B SULFATES AND GRAMICIDIN	GRAMICIDIN; NEOMYCIN SULFATE; POLYMYXIN B SULFATE
PEDIOTIC	HYDROCORTISONE; NEOMYCIN SULFATE; POLYMYXIN B SULFATE
BACITRACIN ZINC-POLYMYXIN B SULFATE	BACITRACIN ZINC; POLYMYXIN B SULFATE
BACITRACIN ZINC AND POLYMYXIN B SULFATE	BACITRACIN ZINC; POLYMYXIN B SULFATE
NEOMYCIN SULFATE AND DEXAMETHASONE SODIUM PHOSPHATE	DEXAMETHASONE SODIUM PHOSPHATE; NEOMYCIN SULFATE
NEOMYCIN AND POLYMYXIN B SULFATES, BACITRACIN ZINC AND HYDROCORTISONE	BACITRACIN ZINC; HYDROCORTISONE; NEOMYCIN SULFATE; POLYMYXIN B SULFATE
TRIMETHOPRIM SULFATE AND POLYMYXIN B SULFATE	POLYMYXIN B SULFATE; TRIMETHOPRIM SULFATE
TOBRAMYCIN AND DEXAMETHASONE	DEXAMETHASONE; TOBRAMYCIN
AMOXICILLIN AND CLAVULANATE POTASSIUM	AMOXICILLIN; CLAVULANATE POTASSIUM
AMPICILLIN AND SULBACTAM	AMPICILLIN SODIUM; SULBACTAM SODIUM
ERYTHROMYCIN AND BENZOYL PEROXIDE	BENZOYL PEROXIDE; ERYTHROMYCIN
RIFAMPIN AND ISONIAZID	ISONIAZID; RIFAMPIN
PIPERACILLIN AND TAZOBACTAM	PIPERACILLIN SODIUM; TAZOBACTAM SODIUM
CLINDAMYCIN PHOSPHATE AND BENZOYL PEROXIDE	BENZOYL PEROXIDE; CLINDAMYCIN PHOSPHATE
SULFAMETHOPRIM	SULFAMETHOXAZOLE; TRIMETHOPRIM
SULFAMETHOXAZOLE AND TRIMETHOPRIM SINGLE STRENGTH	SULFAMETHOXAZOLE; TRIMETHOPRIM
SULFAMETHOPRIM-DS	SULFAMETHOXAZOLE; TRIMETHOPRIM
COTRIM	SULFAMETHOXAZOLE; TRIMETHOPRIM
COTRIM D.S.	SULFAMETHOXAZOLE; TRIMETHOPRIM
SULMEPRIM	SULFAMETHOXAZOLE; TRIMETHOPRIM
SULMEPRIM PEDIATRIC	SULFAMETHOXAZOLE; TRIMETHOPRIM
SULFATRIM-SS	SULFAMETHOXAZOLE; TRIMETHOPRIM
SULFATRIM-DS	SULFAMETHOXAZOLE; TRIMETHOPRIM
PROPACET 100	ACETAMINOPHEN; PROPOXYPHENE NAPSYLATE
PROPOXYPHENE NAPSYLATE AND ACETAMINOPHEN	ACETAMINOPHEN; PROPOXYPHENE NAPSYLATE
METHYLDOPA AND HYDROCHLOROTHIAZIDE	HYDROCHLOROTHIAZIDE; METHYLDOPA
PERPHENAZINE AND AMITRIPTYLINE HYDROCHLORIDE	AMITRIPTYLINE HYDROCHLORIDE; PERPHENAZINE
PROPRANOLOL HYDROCHLORIDE AND HYDROCHLOROTHIAZIDE	HYDROCHLOROTHIAZIDE; PROPRANOLOL HYDROCHLORIDE
HYDRO-RIDE	AMILORIDE HYDROCHLORIDE; HYDROCHLOROTHIAZIDE
CHLORDIAZEPOXIDE AND AMITRIPTYLINE HYDROCHLORIDE	AMITRIPTYLINE HYDROCHLORIDE; CHLORDIAZEPOXIDE
METHYLDOPA AND CHLOROTHIAZIDE	CHLOROTHIAZIDE; METHYLDOPA
NORETHINDRONE AND ETHINYL ESTRADIOL	ETHINYL ESTRADIOL; NORETHINDRONE
NORETHINDRONE AND MESTRANOL	MESTRANOL; NORETHINDRONE
DISOBROM	DEXBROMPHENIRAMINE MALEATE; PSEUDOEPHEDRINE SULFATE
AMILORIDE HYDROCHLORIDE AND HYDROCHLOROTHIAZIDE	AMILORIDE HYDROCHLORIDE; HYDROCHLOROTHIAZIDE
NORETHINDRONE AND ETHINYL ESTRADIOL (7/14)	ETHINYL ESTRADIOL; NORETHINDRONE
NORETHINDRONE AND ETHINYL ESTRADIOL (10/11)	ETHINYL ESTRADIOL; NORETHINDRONE
PROPRANOLOL HYDROCHLORIDE & HYDROCHLOROTHIAZIDE	HYDROCHLOROTHIAZIDE; PROPRANOLOL HYDROCHLORIDE
CLONIDINE HYDROCHLORIDE AND CHLORTHALIDONE	CHLORTHALIDONE; CLONIDINE HYDROCHLORIDE
BUPIVACAINE HYDROCHLORIDE AND EPINEPHRINE	BUPIVACAINE HYDROCHLORIDE; EPINEPHRINE BITARTRATE
TRIAMTERENE AND HYDROCHLOROTHIAZIDE	HYDROCHLOROTHIAZIDE; TRIAMTERENE
E-Z-EM PREP LYTE	POLYETHYLENE GLYCOL 3350; POTASSIUM CHLORIDE; SODIUM BICARBONATE; SODIUM CHLORIDE; SODIUM SULFATE ANHYDROUS
COLOVAGE	POLYETHYLENE GLYCOL 3350; POTASSIUM CHLORIDE; SODIUM BICARBONATE; SODIUM CHLORIDE; SODIUM SULFATE ANHYDROUS
CLORPRES	CHLORTHALIDONE; CLONIDINE HYDROCHLORIDE
NORETHIN 1/35E-21	ETHINYL ESTRADIOL; NORETHINDRONE
NORETHIN 1/35E-28	ETHINYL ESTRADIOL; NORETHINDRONE
NORETHIN 1/50M-21	MESTRANOL; NORETHINDRONE
NORETHIN 1/50M-28	MESTRANOL; NORETHINDRONE
N.E.E. 1/35 21	ETHINYL ESTRADIOL; NORETHINDRONE
N.E.E. 1/35 28	ETHINYL ESTRADIOL; NORETHINDRONE
NORCEPT-E 1/35 21	ETHINYL ESTRADIOL; NORETHINDRONE
NORCEPT-E 1/35 28	ETHINYL ESTRADIOL; NORETHINDRONE
FOAMCOAT	ALUMINUM HYDROXIDE; MAGNESIUM TRISILICATE
TRIPROLIDINE AND PSEUDOEPHEDRINE HYDROCHLORIDES	PSEUDOEPHEDRINE HYDROCHLORIDE; TRIPROLIDINE HYDROCHLORIDE
UROPLUS SS	SULFAMETHOXAZOLE; TRIMETHOPRIM
UROPLUS DS	SULFAMETHOXAZOLE; TRIMETHOPRIM
FENTANYL CITRATE AND DROPERIDOL	DROPERIDOL; FENTANYL CITRATE
TRIMETH/SULFA	SULFAMETHOXAZOLE; TRIMETHOPRIM
ATENOLOL AND CHLORTHALIDONE	ATENOLOL; CHLORTHALIDONE
GLYCOPREP	POLYETHYLENE GLYCOL 3350; POTASSIUM CHLORIDE; SODIUM BICARBONATE; SODIUM CHLORIDE; SODIUM SULFATE ANHYDROUS
FOAMICON	ALUMINUM HYDROXIDE; MAGNESIUM TRISILICATE
NORTREL 0.5/35-21	ETHINYL ESTRADIOL; NORETHINDRONE
NORTREL 1/35-21	ETHINYL ESTRADIOL; NORETHINDRONE
GENCEPT 10/11-21	ETHINYL ESTRADIOL; NORETHINDRONE
NORTREL 0.5/35-28	ETHINYL ESTRADIOL; NORETHINDRONE
NORTREL 1/35-28	ETHINYL ESTRADIOL; NORETHINDRONE
GENCEPT 10/11-28	ETHINYL ESTRADIOL; NORETHINDRONE
ZOVIA 1/35E-21	ETHINYL ESTRADIOL; ETHYNODIOL DIACETATE
ZOVIA 1/35E-28	ETHINYL ESTRADIOL; ETHYNODIOL DIACETATE
ZOVIA 1/50E-21	ETHINYL ESTRADIOL; ETHYNODIOL DIACETATE
ZOVIA 1/50E-28	ETHINYL ESTRADIOL; ETHYNODIOL DIACETATE
PEG-LYTE	POLYETHYLENE GLYCOL 3350; POTASSIUM CHLORIDE; SODIUM BICARBONATE; SODIUM CHLORIDE; SODIUM SULFATE ANHYDROUS
CARBIDOPA AND LEVODOPA	CARBIDOPA; LEVODOPA
CO-LAV	POLYETHYLENE GLYCOL 3350; POTASSIUM CHLORIDE; SODIUM BICARBONATE; SODIUM CHLORIDE; SODIUM SULFATE ANHYDROUS
GO-EVAC	POLYETHYLENE GLYCOL 3350; POTASSIUM CHLORIDE; SODIUM BICARBONATE; SODIUM CHLORIDE; SODIUM SULFATE ANHYDROUS
LEVORA 0.15/30-21	ETHINYL ESTRADIOL; LEVONORGESTREL
LEVORA 0.15/30-28	ETHINYL ESTRADIOL; LEVONORGESTREL
MENOTROPINS	MENOTROPINS (FSH;LH)
SULFACETAMIDE SODIUM AND PREDNISOLONE SODIUM PHOSPHATE	PREDNISOLONE SODIUM PHOSPHATE; SULFACETAMIDE SODIUM
BUTALBITAL, ASPIRIN, CAFFEINE, AND CODEINE PHOSPHATE	ASPIRIN; BUTALBITAL; CAFFEINE; CODEINE PHOSPHATE
SULSTER	PREDNISOLONE SODIUM PHOSPHATE; SULFACETAMIDE SODIUM
TRIVORA-21	ETHINYL ESTRADIOL; LEVONORGESTREL
TRIVORA-28	ETHINYL ESTRADIOL; LEVONORGESTREL
IBUPROHM COLD AND SINUS	IBUPROFEN; PSEUDOEPHEDRINE HYDROCHLORIDE
ORPHENADRINE CITRATE, ASPIRIN, AND CAFFEINE	ASPIRIN; CAFFEINE; ORPHENADRINE CITRATE
ACETAMINOPHEN AND PENTAZOCINE HYDROCHLORIDE	ACETAMINOPHEN; PENTAZOCINE HYDROCHLORIDE
NALOXONE HYDROCHLORIDE AND PENTAZOCINE HYDROCHLORIDE	NALOXONE HYDROCHLORIDE; PENTAZOCINE HYDROCHLORIDE
CAPTOPRIL AND HYDROCHLOROTHIAZIDE	CAPTOPRIL; HYDROCHLOROTHIAZIDE
INVAGESIC	ASPIRIN; CAFFEINE; ORPHENADRINE CITRATE
INVAGESIC FORTE	ASPIRIN; CAFFEINE; ORPHENADRINE CITRATE
PHRENILIN WITH CAFFEINE AND CODEINE	ACETAMINOPHEN; BUTALBITAL; CAFFEINE; CODEINE PHOSPHATE
CODAMINE	HYDROCODONE BITARTRATE; PHENYLPROPANOLAMINE HYDROCHLORIDE
ORPHENGESIC	ASPIRIN; CAFFEINE; ORPHENADRINE CITRATE
ORPHENGESIC FORTE	ASPIRIN; CAFFEINE; ORPHENADRINE CITRATE
DESOGESTREL AND ETHINYL ESTRADIOL	DESOGESTREL; ETHINYL ESTRADIOL
LOW-OGESTREL-21	ETHINYL ESTRADIOL; NORGESTREL
LOW-OGESTREL-28	ETHINYL ESTRADIOL; NORGESTREL
CARDIOPLEGIC IN PLASTIC CONTAINER	CALCIUM CHLORIDE; MAGNESIUM CHLORIDE; POTASSIUM CHLORIDE; SODIUM CHLORIDE
OGESTREL 0.5/50-21	ETHINYL ESTRADIOL; NORGESTREL
OGESTREL 0.5/50-28	ETHINYL ESTRADIOL; NORGESTREL
BISOPROLOL FUMARATE AND HYDROCHLOROTHIAZIDE	BISOPROLOL FUMARATE; HYDROCHLOROTHIAZIDE
NORTREL 7/7/7	ETHINYL ESTRADIOL; NORETHINDRONE
CLOTRIMAZOLE AND BETAMETHASONE DIPROPIONATE	BETAMETHASONE DIPROPIONATE; CLOTRIMAZOLE
BALANCED SALT	CALCIUM CHLORIDE; MAGNESIUM CHLORIDE; POTASSIUM CHLORIDE; SODIUM ACETATE; SODIUM CHLORIDE; SODIUM CITRATE
MICROGESTIN FE 1.5/30	ETHINYL ESTRADIOL; NORETHINDRONE ACETATE
MICROGESTIN 1.5/30	ETHINYL ESTRADIOL; NORETHINDRONE ACETATE
IBUPROFEN AND PSEUDOEPHEDRINE HYDROCHLORIDE	IBUPROFEN; PSEUDOEPHEDRINE HYDROCHLORIDE
BUTALBITAL, ACETAMINOPHEN, CAFFEINE AND CODEINE PHOSPHATE	ACETAMINOPHEN; BUTALBITAL; CAFFEINE; CODEINE PHOSPHATE
ENALAPRIL MALEATE AND HYDROCHLOROTHIAZIDE	ENALAPRIL MALEATE; HYDROCHLOROTHIAZIDE
MICROGESTIN FE 1/20	ETHINYL ESTRADIOL; NORETHINDRONE ACETATE
MICROGESTIN 1/20	ETHINYL ESTRADIOL; NORETHINDRONE ACETATE
LORATADINE AND PSEUDOEPHEDRINE SULFATE	LORATADINE; PSEUDOEPHEDRINE SULFATE
LISINOPRIL AND HYDROCHLOROTHIAZIDE	HYDROCHLOROTHIAZIDE; LISINOPRIL
ACETAMINOPHEN, ASPIRIN AND CAFFEINE	ACETAMINOPHEN; ASPIRIN; CAFFEINE
AVIANE-28	ETHINYL ESTRADIOL; LEVONORGESTREL
AVIANE-21	ETHINYL ESTRADIOL; LEVONORGESTREL
LESSINA-21	ETHINYL ESTRADIOL; LEVONORGESTREL
LESSINA-28	ETHINYL ESTRADIOL; LEVONORGESTREL
SPRINTEC	ETHINYL ESTRADIOL; NORGESTIMATE
TRI-SPRINTEC	ETHINYL ESTRADIOL; NORGESTIMATE
ENPRESSE-21	ETHINYL ESTRADIOL; LEVONORGESTREL
ENPRESSE-28	ETHINYL ESTRADIOL; LEVONORGESTREL
CRYSELLE	ETHINYL ESTRADIOL; NORGESTREL
LEVONORGESTREL AND ETHINYL ESTRADIOL	ETHINYL ESTRADIOL; LEVONORGESTREL
KARIVA	DESOGESTREL; ETHINYL ESTRADIOL
PORTIA-21	ETHINYL ESTRADIOL; LEVONORGESTREL
PORTIA-28	ETHINYL ESTRADIOL; LEVONORGESTREL
IFOSFAMIDE/MESNA KIT	IFOSFAMIDE; MESNA
HYDROCODONE BITARTRATE AND IBUPROFEN	HYDROCODONE BITARTRATE; IBUPROFEN
LOPERAMIDE HYDROCHLORIDE AND SIMETHICONE	LOPERAMIDE HYDROCHLORIDE; SIMETHICONE
JUNEL FE 1.5/30	ETHINYL ESTRADIOL; NORETHINDRONE ACETATE
JUNEL FE 1/20	ETHINYL ESTRADIOL; NORETHINDRONE ACETATE
TRI-LEGEST FE	ETHINYL ESTRADIOL; NORETHINDRONE ACETATE
BALZIVA-21	ETHINYL ESTRADIOL; NORETHINDRONE
NORETHINDRONE ACETATE AND ETHINYL ESTRADIOL	ETHINYL ESTRADIOL; NORETHINDRONE ACETATE
FEXOFENADINE HYDROCHLORIDE AND PSEUDOEPHEDRINE HYDROCHLORIDE	FEXOFENADINE HYDROCHLORIDE; PSEUDOEPHEDRINE HYDROCHLORIDE
BALZIVA-28	ETHINYL ESTRADIOL; NORETHINDRONE
LIDOCAINE AND PRILOCAINE	LIDOCAINE; PRILOCAINE
PREVIFEM	ETHINYL ESTRADIOL; NORGESTIMATE
TRI-PREVIFEM	ETHINYL ESTRADIOL; NORGESTIMATE
CYCLAFEM 1/35	ETHINYL ESTRADIOL; NORETHINDRONE
CYCLAFEM 7/7/7	ETHINYL ESTRADIOL; NORETHINDRONE
BENAZEPRIL HYDROCHLORIDE AND HYDROCHLOROTHIAZIDE	BENAZEPRIL HYDROCHLORIDE; HYDROCHLOROTHIAZIDE
GLYBURIDE AND METFORMIN HYDROCHLORIDE	GLYBURIDE; METFORMIN HYDROCHLORIDE
QUINARETIC	HYDROCHLOROTHIAZIDE; QUINAPRIL HYDROCHLORIDE
JUNEL 1/20	ETHINYL ESTRADIOL; NORETHINDRONE ACETATE
JUNEL 1.5/30	ETHINYL ESTRADIOL; NORETHINDRONE ACETATE
TRI-LEGEST 21	ETHINYL ESTRADIOL; NORETHINDRONE ACETATE
DARVOCET A500	ACETAMINOPHEN; PROPOXYPHENE NAPSYLATE
VELIVET	DESOGESTREL; ETHINYL ESTRADIOL
DESOGESTREL; ETHINYL	DESOGESTREL; ETHINYL ESTRADIOL
TRAMADOL HYDROCHLORIDE AND ACETAMINOPHEN	ACETAMINOPHEN; TRAMADOL HYDROCHLORIDE
TRILYTE	POLYETHYLENE GLYCOL 3350; POTASSIUM CHLORIDE; SODIUM BICARBONATE; SODIUM CHLORIDE
NAPROXEN SODIUM AND PSEUDOEPHEDRINE HYDROCHLORIDE	NAPROXEN SODIUM; PSEUDOEPHEDRINE HYDROCHLORIDE
BUTALBITAL; ACETAMINOPHEN; CAFFEINE; CODEINE	BUTALBITAL; ACETAMINOPHEN; CAFFEINE; CODEINE PHOSPHATE
DEXTROAMP SACCHARATE,AMP ASPARTATE,DEXTROAMP SULFATE AND AMP SULFATE	AMPHETAMINE ASPARTATE; AMPHETAMINE SULFATE; DEXTROAMPHETAMINE SACCHARATE; DEXTROAMPHETAMINE SULFATE
FEXOFENADINE HCL; PSEUDOEPHEDRINE HCL	FEXOFENADINE HYDROCHLORIDE; PSEUDOEPHEDRINE HYDROCHLORIDE
FOSINOPRIL SODIUM AND HYDROCHLOROTHIAZIDE	FOSINOPRIL SODIUM; HYDROCHLOROTHIAZIDE
NORGESTIMATE AND ETHINYL ESTRADIOL	ETHINYL ESTRADIOL; NORGESTIMATE
REPREXAIN	HYDROCODONE BITARTRATE; IBUPROFEN
CARBILEV	CARBIDOPA; LEVODOPA
NITROFURANTOIN (MONOHYDRATE/MACROCRYSTALS)	NITROFURANTOIN; NITROFURANTOIN, MACROCRYSTALLINE
EMOQUETTE	DESOGESTREL; ETHINYL ESTRADIOL
KIMIDESS	DESOGESTREL; ETHINYL ESTRADIOL
PARCOPA	CARBIDOPA; LEVODOPA
ALBUTEROL SULFATE AND IPRATROPIUM BROMIDE	ALBUTEROL SULFATE; IPRATROPIUM BROMIDE
ALBUTEROL SULFATE; IPRATROPIUM BROMIDE	ALBUTEROL SULFATE; IPRATROPIUM BROMIDE
ARANELLE	NORETHINDRONE; ETHINYL ESTRADIOL
TRI LO SPRINTEC	ETHINYL ESTRADIOL; NORGESTIMATE
KELNOR	ETHINYL ESTRADIOL; ETHYNODIOL DIACETATE
METOPROLOL TARTRATE AND HYDROCHLOROTHIAZIDE	HYDROCHLOROTHIAZIDE; METOPROLOL TARTRATE
ESTRADIOL AND NORGESTIMATE	ESTRADIOL; NORGESTIMATE
MOEXIPRIL HYDROCHLORIDE AND HYDROCHLOROTHIAZIDE	HYDROCHLOROTHIAZIDE; MOEXIPRIL HYDROCHLORIDE
GILDESS FE 1.5/30	ETHINYL ESTRADIOL; NORETHINDRONE ACETATE
GILDESS 1.5/30	ETHINYL ESTRADIOL; NORETHINDRONE ACETATE
GILDESS FE 1/20	ETHINYL ESTRADIOL; NORETHINDRONE ACETATE
GILDESS 1/20	ETHINYL ESTRADIOL; NORETHINDRONE ACETATE
QUINAPRIL HYDROCHLORIDE AND HYDROCHLOROTHIAZIDE	HYDROCHLOROTHIAZIDE; QUINAPRIL HYDROCHLORIDE
ORSYTHIA	ETHINYL ESTRADIOL; LEVONORGESTREL
QUASENSE	ETHINYL ESTRADIOL; LEVONORGESTREL
LOSARTAN POTASSIUM AND HYDROCHLOROTHIAZIDE	HYDROCHLOROTHIAZIDE; LOSARTAN POTASSIUM
CETIRIZINE HYDROCHLORIDE AND PSEUDOEPHEDRINE HYDROCHLORIDE	CETIRIZINE HYDROCHLORIDE; PSEUDOEPHEDRINE HYDROCHLORIDE
AMLODIPINE BESYLATE AND BENAZEPRIL HYDROCHLORIDE	AMLODIPINE BESYLATE; BENAZEPRIL HYDROCHLORIDE
DESOGESTREL; ETHINYL ESTRADIOL	DESOGESTREL; ETHINYL ESTRADIOL
GLIPIZIDE AND METFORMIN HYDROCHLORIDE	GLIPIZIDE; METFORMIN HYDROCHLORIDE
TUSSICAPS	CHLORPHENIRAMINE POLISTIREX; HYDROCODONE POLISTIREX
ROSIGLITAZONE MALEATE AND METFORMIN HYDROCHLORIDE	METFORMIN HYDROCHLORIDE; ROSIGLITAZONE MALEATE
FAMOTIDINE, CALCIUM CARBONATE, AND MAGNESIUM HYDROXIDE	CALCIUM CARBONATE; FAMOTIDINE; MAGNESIUM HYDROXIDE
IRBESARTAN AND HYDROCHLOROTHIAZIDE	HYDROCHLOROTHIAZIDE; IRBESARTAN
CIPROFLOXACIN EXTENDED RELEASE	CIPROFLOXACIN; CIPROFLOXACIN HYDROCHLORIDE
MYZILRA	ETHINYL ESTRADIOL; LEVONORGESTREL
DROSPIRENONE AND ETHINYL ESTRADIOL	DROSPIRENONE; ETHINYL ESTRADIOL
OLANZAPINE AND FLUOXETINE HYDROCHLORIDE	FLUOXETINE HYDROCHLORIDE; OLANZAPINE
NADOLOL AND BENDROFLUMETHIAZIDE	BENDROFLUMETHIAZIDE; NADOLOL
DORZOLAMIDE HYDROCHLORIDE AND TIMOLOL MALEATE	DORZOLAMIDE HYDROCHLORIDE; TIMOLOL MALEATE
FEXOFENADINE HYDROCHLORIDE; PSEUDOEPHEDRINE HYDROCHLORIDE	FEXOFENADINE HYDROCHLORIDE; PSEUDOEPHEDRINE HYDROCHLORIDE
VALSARTAN AND HYDROCHLOROTHIAZIDE	HYDROCHLOROTHIAZIDE; VALSARTAN
BUTALBITAL, ASPIRIN AND CAFFEINE	ASPIRIN; BUTALBITAL; CAFFEINE
NAPHAZOLINE HYDROCHLORIDE AND PHENIRAMINE MALEATE	NAPHAZOLINE HYDROCHLORIDE; PHENIRAMINE MALEATE
NORETHINDRONE ACETATE AND ETHINYL ESTRADIOL AND FERROUS FUMARATE	ETHINYL ESTRADIOL; NORETHINDRONE ACETATE
OXYCODONE HYDROCHLORIDE AND IBUPROFEN	IBUPROFEN; OXYCODONE HYDROCHLORIDE
ESTRADIOL AND NORETHINDRONE ACETATE	ESTRADIOL; NORETHINDRONE ACETATE
DESLORATADINE AND PSEUDOEPHEDRINE SULFATE 24 HOUR	DESLORATADINE; PSEUDOEPHEDRINE SULFATE
GILDAGIA	ETHINYL ESTRADIOL; NORETHINDRONE
POTASSIUM CHLORIDE 0.149% IN SODIUM CHLORIDE 0.45% IN PLASTIC CONTAINER	POTASSIUM CHLORIDE; SODIUM CHLORIDE
AMLODIPINE BESYLATE; BENAZEPRIL HYDROCHLORIDE	AMLODIPINE BESYLATE; BENAZEPRIL HYDROCHLORIDE
DEXBROMPHENIRAMINE MALEATE AND PSEUDOEPHEDRINE SULFATE	DEXBROMPHENIRAMINE MALEATE; PSEUDOEPHEDRINE SULFATE
ROSIGLITAZONE MALEATE AND GLIMEPIRIDE	GLIMEPIRIDE; ROSIGLITAZONE MALEATE
ASPIRIN AND DIPYRIDAMOLE	ASPIRIN; DIPYRIDAMOLE
OLMESARTAN MEDOXOMIL AND HYDROCHLOROTHIAZIDE	HYDROCHLOROTHIAZIDE; OLMESARTAN MEDOXOMIL
LEVONORGESTREL AND ETHINYL ESTRADIOL AND ETHINYL ESTRADIOL	ETHINYL ESTRADIOL; LEVONORGESTREL
PRILOCAINE HYDROCHLORIDE AND EPINEPHRINE BITARTRATE	EPINEPHRINE BITARTRATE; PRILOCAINE HYDROCHLORIDE
OMEPRAZOLE AND SODIUM BICARBONATE	OMEPRAZOLE; SODIUM BICARBONATE
INTROVALE	ETHINYL ESTRADIOL; LEVONORGESTREL
LOPINAVIR; RITONAVIR	LOPINAVIR;RITONAVIR
CARBIDOPA, LEVODOPA AND ENTACAPONE	CARBIDOPA; ENTACAPONE; LEVODOPA
ALTAVERA	ETHINYL ESTRADIOL; LEVONORGESTREL
IBUPROFEN AND DIPHENHYDRAMINE CITRATE	DIPHENHYDRAMINE CITRATE; IBUPROFEN
TRANDOLAPRIL AND VERAPAMIL HYDROCHLORIDE	TRANDOLAPRIL; VERAPAMIL HYDROCHLORIDE
ARTICAINE HYDROCHLORIDE AND EPINEPHRINE BITARTRATE	ARTICAINE HYDROCHLORIDE; EPINEPHRINE BITARTRATE
LORYNA	DROSPIRENONE; ETHINYL ESTRADIOL
LAX-LYTE WITH FLAVOR PACKS	POLYETHYLENE GLYCOL 3350; POTASSIUM CHLORIDE; SODIUM BICARBONATE; SODIUM CHLORIDE
ABACAVIR SULFATE AND LAMIVUDINE	ABACAVIR SULFATE; LAMIVUDINE
MONOBASIC SODIUM PHOSPHATE AND DIBASIC SODIUM PHOSPHATE	SODIUM PHOSPHATE, DIBASIC, ANHYDROUS; SODIUM PHOSPHATE, MONOBASIC, MONOHYDRATE
SULFOSE	TRISULFAPYRIMIDINES (SULFADIAZINE;SULFAMERAZINE;SULFAMETHAZINE)
PROPOXYPHENE COMPOUND 65	ASPIRIN; CAFFEINE; PROPOXYPHENE HYDROCHLORIDE
NEOPASALATE	AMINOSALICYLATE SODIUM; AMINOSALICYLIC ACID
SULFA-TRIPLE #2	TRISULFAPYRIMIDINES (SULFADIAZINE;SULFAMERAZINE;SULFAMETHAZINE)
TRIPLE SULFA	TRIPLE SULFA (SULFABENZAMIDE;SULFACETAMIDE;SULFATHIAZOLE)
TRIPLE SULFOID	TRISULFAPYRIMIDINES (SULFADIAZINE;SULFAMERAZINE;SULFAMETHAZINE)
SULFALOID	TRISULFAPYRIMIDINES (SULFADIAZINE;SULFAMERAZINE;SULFAMETHAZINE)
LANTRISUL	TRISULFAPYRIMIDINES (SULFADIAZINE;SULFAMERAZINE;SULFAMETHAZINE)
SORBITOL-MANNITOL	MANNITOL; SORBITOL
LIDOCAINE HYDROCHLORIDE W/ EPINEPHRINE	EPINEPHRINE; LIDOCAINE HYDROCHLORIDE
CARMOL HC	HYDROCORTISONE ACETATE; UREA
PROCAINE HYDROCHLORIDE W/ EPINEPHRINE	EPINEPHRINE; PROCAINE HYDROCHLORIDE
ACETAMINOPHEN, ASPIRIN, AND CODEINE PHOSPHATE	ACETAMINOPHEN; ASPIRIN; CODEINE PHOSPHATE
METHOCARBAMOL AND ASPIRIN	ASPIRIN; METHOCARBAMOL
PROPOXYPHENE COMPOUND-65	ASPIRIN; CAFFEINE; PROPOXYPHENE HYDROCHLORIDE
PRAMOSONE	HYDROCORTISONE ACETATE; PRAMOXINE HYDROCHLORIDE
PROBENECID W/ COLCHICINE	COLCHICINE; PROBENECID
ALCOHOL 5% IN DEXTROSE 5% IN WATER	ALCOHOL; DEXTROSE
ALCOHOL 5% IN D5-W	ALCOHOL; DEXTROSE
DELCOBESE	AMPHETAMINE ADIPATE; AMPHETAMINE SULFATE; DEXTROAMPHETAMINE ADIPATE; DEXTROAMPHETAMINE SULFATE
HYDROCHLOROTHIAZIDE W/ RESERPINE	HYDROCHLOROTHIAZIDE; RESERPINE
CAPITAL AND CODEINE	ACETAMINOPHEN; CODEINE PHOSPHATE
HYDROCHLOROTHIAZIDE W/ RESERPINE AND HYDRALAZINE	HYDRALAZINE HYDROCHLORIDE; HYDROCHLOROTHIAZIDE; RESERPINE
HYDROSERPINE PLUS (R-H-H)	HYDRALAZINE HYDROCHLORIDE; HYDROCHLOROTHIAZIDE; RESERPINE
CALMURID HC	HYDROCORTISONE; UREA
EMPRACET W/ CODEINE PHOSPHATE #3	ACETAMINOPHEN; CODEINE PHOSPHATE
EMPRACET W/ CODEINE PHOSPHATE #4	ACETAMINOPHEN; CODEINE PHOSPHATE
OCTOCAINE	EPINEPHRINE; LIDOCAINE HYDROCHLORIDE
COL-PROBENECID	COLCHICINE; PROBENECID
HYDRALAZINE HYDROCHLORIDE, HYDROCHLOROTHIAZIDE AND RESERPINE	HYDRALAZINE HYDROCHLORIDE; HYDROCHLOROTHIAZIDE; RESERPINE
CYCLOMYDRIL	CYCLOPENTOLATE HYDROCHLORIDE; PHENYLEPHRINE HYDROCHLORIDE
PHENAPHEN W/ CODEINE NO. 2	ACETAMINOPHEN; CODEINE PHOSPHATE
PHENAPHEN W/ CODEINE NO. 3	ACETAMINOPHEN; CODEINE PHOSPHATE
PHENAPHEN W/ CODEINE NO. 4	ACETAMINOPHEN; CODEINE PHOSPHATE
DOMEBORO	ACETIC ACID, GLACIAL; ALUMINUM ACETATE
COMPOUND 65	ASPIRIN; CAFFEINE; PROPOXYPHENE HYDROCHLORIDE
RESERPINE AND HYDROCHLOROTHIAZIDE	HYDROCHLOROTHIAZIDE; RESERPINE
DRALSERP	HYDRALAZINE HYDROCHLORIDE; RESERPINE
ISOCAINE HYDROCHLORIDE W/ LEVONORDEFRIN	LEVONORDEFRIN; MEPIVACAINE HYDROCHLORIDE
HYDRO-RESERP	HYDROCHLOROTHIAZIDE; RESERPINE
ALPHACAINE HYDROCHLORIDE W/ EPINEPHRINE	EPINEPHRINE; LIDOCAINE HYDROCHLORIDE
LIDOCATON	EPINEPHRINE; LIDOCAINE HYDROCHLORIDE
APRESAZIDE	HYDRALAZINE HYDROCHLORIDE; HYDROCHLOROTHIAZIDE
HYDRO-SERP ""25""	HYDROCHLOROTHIAZIDE; RESERPINE
MEPIVACAINE HYDROCHLORIDE W/ LEVONORDEFRIN	LEVONORDEFRIN; MEPIVACAINE HYDROCHLORIDE
CHLOROTHIAZIDE W/ RESERPINE	CHLOROTHIAZIDE; RESERPINE
MERSALYL-THEOPHYLLINE	MERSALYL SODIUM; THEOPHYLLINE
HYDRAP-ES	HYDRALAZINE HYDROCHLORIDE; HYDROCHLOROTHIAZIDE; RESERPINE
CAM-AP-ES	HYDRALAZINE HYDROCHLORIDE; HYDROCHLOROTHIAZIDE; RESERPINE
MICRAININ	ASPIRIN; MEPROBAMATE
WYGESIC	ACETAMINOPHEN; PROPOXYPHENE HYDROCHLORIDE
ARESTOCAINE HYDROCHLORIDE W/ LEVONORDEFRIN	LEVONORDEFRIN; MEPIVACAINE HYDROCHLORIDE
TYLENOL W/ CODEINE NO. 1	ACETAMINOPHEN; CODEINE PHOSPHATE
TYLENOL W/ CODEINE NO. 2	ACETAMINOPHEN; CODEINE PHOSPHATE
TYLENOL W/ CODEINE NO. 3	ACETAMINOPHEN; CODEINE PHOSPHATE
TYLENOL W/ CODEINE NO. 4	ACETAMINOPHEN; CODEINE PHOSPHATE
TYLENOL W/ CODEINE	ACETAMINOPHEN; CODEINE PHOSPHATE
DOLENE AP-65	ACETAMINOPHEN; PROPOXYPHENE HYDROCHLORIDE
MEPERIDINE AND ATROPINE SULFATE	ATROPINE SULFATE; MEPERIDINE HYDROCHLORIDE
LOW-QUEL	ATROPINE SULFATE; DIPHENOXYLATE HYDROCHLORIDE
HYDRO-SERP ""50""	HYDROCHLOROTHIAZIDE; RESERPINE
TRICHLORMETHIAZIDE W/ RESERPINE	RESERPINE; TRICHLORMETHIAZIDE
DI-ATRO	ATROPINE SULFATE; DIPHENOXYLATE HYDROCHLORIDE
TRIPROLIDINE HYDROCHLORIDE AND PSEUDOEPHEDRINE HYDROCHLORIDE	PSEUDOEPHEDRINE HYDROCHLORIDE; TRIPROLIDINE HYDROCHLORIDE
LONOX	ATROPINE SULFATE; DIPHENOXYLATE HYDROCHLORIDE
H.R.-50	HYDROCHLOROTHIAZIDE; RESERPINE
HYDROCHLOROTHIAZIDE W/ HYDRALAZINE	HYDRALAZINE HYDROCHLORIDE; HYDROCHLOROTHIAZIDE
TYLOX	ACETAMINOPHEN; OXYCODONE HYDROCHLORIDE
HYDRALAZINE HYDROCHLORIDE AND HYDROCHLOROTHIAZIDE	HYDRALAZINE HYDROCHLORIDE; HYDROCHLOROTHIAZIDE
ACETIC ACID W/ HYDROCORTISONE	ACETIC ACID, GLACIAL; HYDROCORTISONE
RESERPINE, HYDRALAZINE HYDROCHLORIDE AND HYDROCHLOROTHIAZIDE	HYDRALAZINE HYDROCHLORIDE; HYDROCHLOROTHIAZIDE; RESERPINE
PROBEN-C	COLCHICINE; PROBENECID
TESTOSTERONE CYPIONATE-ESTRADIOL CYPIONATE	ESTRADIOL CYPIONATE; TESTOSTERONE CYPIONATE
CODEINE, ASPIRIN, APAP FORMULA NO. 4	ACETAMINOPHEN; ASPIRIN; CODEINE PHOSPHATE
CODEINE, ASPIRIN, APAP FORMULA NO. 3	ACETAMINOPHEN; ASPIRIN; CODEINE PHOSPHATE
CODEINE, ASPIRIN, APAP FORMULA NO. 2	ACETAMINOPHEN; ASPIRIN; CODEINE PHOSPHATE
VICODIN	ACETAMINOPHEN; HYDROCODONE BITARTRATE
PROVAL #3	ACETAMINOPHEN; CODEINE PHOSPHATE
PROPOXYPHENE HYDROCHLORIDE W/ ASPIRIN AND CAFFEINE	ASPIRIN; CAFFEINE; PROPOXYPHENE HYDROCHLORIDE
COLONAID	ATROPINE SULFATE; DIPHENOXYLATE HYDROCHLORIDE
LOMANATE	ATROPINE SULFATE; DIPHENOXYLATE HYDROCHLORIDE
HYDRALAZINE, HYDROCHLOROTHIAZIDE W/ RESERPINE	HYDRALAZINE HYDROCHLORIDE; HYDROCHLOROTHIAZIDE; RESERPINE
HYDRALAZINE AND HYDROCHLOROTHIAZIDE	HYDRALAZINE HYDROCHLORIDE; HYDROCHLOROTHIAZIDE
PHENAPHEN-650 W/ CODEINE	ACETAMINOPHEN; CODEINE PHOSPHATE
TESTOSTERONE ENANTHATE AND ESTRADIOL VALERATE	ESTRADIOL VALERATE; TESTOSTERONE ENANTHATE
UNIPRES	HYDRALAZINE HYDROCHLORIDE; HYDROCHLOROTHIAZIDE; RESERPINE
OXYCODONE 2.5/APAP 500	ACETAMINOPHEN; OXYCODONE HYDROCHLORIDE
OXYCODONE 5/APAP 500	ACETAMINOPHEN; OXYCODONE HYDROCHLORIDE
SPIRONOLACTONE W/ HYDROCHLOROTHIAZIDE	HYDROCHLOROTHIAZIDE; SPIRONOLACTONE
ALPHADERM	HYDROCORTISONE; UREA
PROCTOFOAM HC	HYDROCORTISONE ACETATE; PRAMOXINE HYDROCHLORIDE
VICOPRIN	ASPIRIN; HYDROCODONE BITARTRATE
DITATE-DS	ESTRADIOL VALERATE; TESTOSTERONE ENANTHATE
DIPHENOXYLATE HYDROCHLORIDE W/ ATROPINE SULFATE	ATROPINE SULFATE; DIPHENOXYLATE HYDROCHLORIDE
EPIFOAM	HYDROCORTISONE ACETATE; PRAMOXINE HYDROCHLORIDE
HYPAQUE-76	DIATRIZOATE MEGLUMINE; DIATRIZOATE SODIUM
SPIRONOLACTONE AND HYDROCHLOROTHIAZIDE	HYDROCHLOROTHIAZIDE; SPIRONOLACTONE
MIGERGOT	CAFFEINE; ERGOTAMINE TARTRATE
WIGRAINE	CAFFEINE; ERGOTAMINE TARTRATE
ORLEX HC	ACETIC ACID, GLACIAL; HYDROCORTISONE
LANORINAL	ASPIRIN; BUTALBITAL; CAFFEINE
ROXICET	ACETAMINOPHEN; OXYCODONE HYDROCHLORIDE
MD-76	DIATRIZOATE MEGLUMINE; DIATRIZOATE SODIUM
MD-60	DIATRIZOATE MEGLUMINE; DIATRIZOATE SODIUM
HYDRALAZINE HYDROCHLORIDE-HYDROCHLOROTHIAZIDE-RESERPINE	HYDRALAZINE HYDROCHLORIDE; HYDROCHLOROTHIAZIDE; RESERPINE
ACETASOL HC	ACETIC ACID, GLACIAL; HYDROCORTISONE
SER-A-GEN	HYDRALAZINE HYDROCHLORIDE; HYDROCHLOROTHIAZIDE; RESERPINE
LORCET-HD	ACETAMINOPHEN; HYDROCODONE BITARTRATE
MD-GASTROVIEW	DIATRIZOATE MEGLUMINE; DIATRIZOATE SODIUM
OXYCET	ACETAMINOPHEN; OXYCODONE HYDROCHLORIDE
CODOXY	ASPIRIN; OXYCODONE HYDROCHLORIDE; OXYCODONE TEREPHTHALATE
ISOPTO CETAPRED	PREDNISOLONE ACETATE; SULFACETAMIDE SODIUM
BUTALBITAL AND ACETAMINOPHEN	ACETAMINOPHEN; BUTALBITAL
ANOQUAN	ACETAMINOPHEN; BUTALBITAL; CAFFEINE
HY-PHEN	ACETAMINOPHEN; HYDROCODONE BITARTRATE
RESERPINE, HYDROCHLOROTHIAZIDE, AND HYDRALAZINE HYDROCHLORIDE	HYDRALAZINE HYDROCHLORIDE; HYDROCHLOROTHIAZIDE; RESERPINE
ANGIOVIST 370	DIATRIZOATE MEGLUMINE; DIATRIZOATE SODIUM
ANGIOVIST 292	DIATRIZOATE MEGLUMINE; DIATRIZOATE SODIUM
GASTROVIST	DIATRIZOATE MEGLUMINE; DIATRIZOATE SODIUM
OXYCODONE AND ASPIRIN (HALF-STRENGTH)	ASPIRIN; OXYCODONE HYDROCHLORIDE; OXYCODONE TEREPHTHALATE
ROXIPRIN	ASPIRIN; OXYCODONE HYDROCHLORIDE; OXYCODONE TEREPHTHALATE
CHLOROTHIAZIDE-RESERPINE	CHLOROTHIAZIDE; RESERPINE
BLEPHAMIDE S.O.P.	PREDNISOLONE ACETATE; SULFACETAMIDE SODIUM
CO-GESIC	ACETAMINOPHEN; HYDROCODONE BITARTRATE
CETAPRED	PREDNISOLONE ACETATE; SULFACETAMIDE SODIUM
DURADYNE DHC	ACETAMINOPHEN; HYDROCODONE BITARTRATE
PHRENILIN	ACETAMINOPHEN; BUTALBITAL
ATROPINE AND DEMEROL	ATROPINE SULFATE; MEPERIDINE HYDROCHLORIDE
TRYSUL	TRIPLE SULFA (SULFABENZAMIDE;SULFACETAMIDE;SULFATHIAZOLE)
BANCAP HC	ACETAMINOPHEN; HYDROCODONE BITARTRATE
PREDSULFAIR	PREDNISOLONE ACETATE; SULFACETAMIDE SODIUM
LO-TROL	ATROPINE SULFATE; DIPHENOXYLATE HYDROCHLORIDE
PAPA-DEINE #3	ACETAMINOPHEN; CODEINE PHOSPHATE
PREDAMIDE	PREDNISOLONE ACETATE; SULFACETAMIDE SODIUM
HYDROPANE	HOMATROPINE METHYLBROMIDE; HYDROCODONE BITARTRATE
SULPHRIN	PREDNISOLONE ACETATE; SULFACETAMIDE SODIUM
HYDROFLUMETHIAZIDE AND RESERPINE	HYDROFLUMETHIAZIDE; RESERPINE
MYFED	PSEUDOEPHEDRINE HYDROCHLORIDE; TRIPROLIDINE HYDROCHLORIDE
TRIPROLIDINE AND PSEUDOEPHEDRINE	PSEUDOEPHEDRINE HYDROCHLORIDE; TRIPROLIDINE HYDROCHLORIDE
DIATRIZOATE-60	DIATRIZOATE MEGLUMINE; DIATRIZOATE SODIUM
RESERPINE AND HYDROCHLOROTHIAZIDE-50	HYDROCHLOROTHIAZIDE; RESERPINE
PSEUDOEPHEDRINE HYDROCHLORIDE AND TRIPROLIDINE HYDROCHLORIDE	PSEUDOEPHEDRINE HYDROCHLORIDE; TRIPROLIDINE HYDROCHLORIDE
TYLOX-325	ACETAMINOPHEN; OXYCODONE HYDROCHLORIDE
HISTAFED	PSEUDOEPHEDRINE HYDROCHLORIDE; TRIPROLIDINE HYDROCHLORIDE
AXOTAL	ASPIRIN; BUTALBITAL
BROMANYL	BROMODIPHENHYDRAMINE HYDROCHLORIDE; CODEINE PHOSPHATE
ACTAHIST	PSEUDOEPHEDRINE HYDROCHLORIDE; TRIPROLIDINE HYDROCHLORIDE
HYDRALAZINE HYDROCHLORIDE W/ HYDROCHLOROTHIAZIDE 25/25	HYDRALAZINE HYDROCHLORIDE; HYDROCHLOROTHIAZIDE
HYDRALAZINE HYDROCHLORIDE W/ HYDROCHLOROTHIAZIDE 50/50	HYDRALAZINE HYDROCHLORIDE; HYDROCHLOROTHIAZIDE
HYDRALAZINE HYDROCHLORIDE W/ HYDROCHLOROTHIAZIDE 100/50	HYDRALAZINE HYDROCHLORIDE; HYDROCHLOROTHIAZIDE
CHLOROTHIAZIDE AND RESERPINE	CHLOROTHIAZIDE; RESERPINE
SCANDONEST L	LEVONORDEFRIN; MEPIVACAINE HYDROCHLORIDE
LIGNOSPAN FORTE	EPINEPHRINE BITARTRATE; LIDOCAINE HYDROCHLORIDE
LIGNOSPAN STANDARD	EPINEPHRINE BITARTRATE; LIDOCAINE HYDROCHLORIDE
METHYCLOTHIAZIDE AND DESERPIDINE	DESERPIDINE; METHYCLOTHIAZIDE
TRILITRON	PSEUDOEPHEDRINE HYDROCHLORIDE; TRIPROLIDINE HYDROCHLORIDE
TUSSIGON	HOMATROPINE METHYLBROMIDE; HYDROCODONE BITARTRATE
DHC PLUS	ACETAMINOPHEN; CAFFEINE; DIHYDROCODEINE BITARTRATE
CORPHED	PSEUDOEPHEDRINE HYDROCHLORIDE; TRIPROLIDINE HYDROCHLORIDE
BOROFAIR	ACETIC ACID, GLACIAL; ALUMINUM ACETATE
GYNE-SULF	TRIPLE SULFA (SULFABENZAMIDE;SULFACETAMIDE;SULFATHIAZOLE)
BROMODIPHENHYDRAMINE HYDROCHLORIDE AND CODEINE PHOSPHATE	BROMODIPHENHYDRAMINE HYDROCHLORIDE; CODEINE PHOSPHATE
TRIPHED	PSEUDOEPHEDRINE HYDROCHLORIDE; TRIPROLIDINE HYDROCHLORIDE
TRIACIN-C	CODEINE PHOSPHATE; PSEUDOEPHEDRINE HYDROCHLORIDE; TRIPROLIDINE HYDROCHLORIDE
PAPA-DEINE #4	ACETAMINOPHEN; CODEINE PHOSPHATE
BROMANATE DM	BROMPHENIRAMINE MALEATE; DEXTROMETHORPHAN HYDROBROMIDE; PSEUDOEPHEDRINE HYDROCHLORIDE
PHERAZINE W/ CODEINE	CODEINE PHOSPHATE; PROMETHAZINE HYDROCHLORIDE
Q-GESIC	ASPIRIN; MEPROBAMATE
PROMETH VC PLAIN	PHENYLEPHRINE HYDROCHLORIDE; PROMETHAZINE HYDROCHLORIDE
PROMETH W/ DEXTROMETHORPHAN	DEXTROMETHORPHAN HYDROBROMIDE; PROMETHAZINE HYDROCHLORIDE
PROMETH VC W/ CODEINE	CODEINE PHOSPHATE; PHENYLEPHRINE HYDROCHLORIDE; PROMETHAZINE HYDROCHLORIDE
CARISOPRODOL COMPOUND	ASPIRIN; CARISOPRODOL
BROMFED-DM	BROMPHENIRAMINE MALEATE; DEXTROMETHORPHAN HYDROBROMIDE; PSEUDOEPHEDRINE HYDROCHLORIDE
PROMETHAZINE W/ CODEINE	CODEINE PHOSPHATE; PROMETHAZINE HYDROCHLORIDE
PROMETHAZINE VC PLAIN	PHENYLEPHRINE HYDROCHLORIDE; PROMETHAZINE HYDROCHLORIDE
PROMETHAZINE VC W/ CODEINE	CODEINE PHOSPHATE; PHENYLEPHRINE HYDROCHLORIDE; PROMETHAZINE HYDROCHLORIDE
VAGILIA	TRIPLE SULFA (SULFABENZAMIDE;SULFACETAMIDE;SULFATHIAZOLE)
PHRENILIN FORTE	ACETAMINOPHEN; BUTALBITAL
TRIPROLIDINE HYDROCHLORIDE, PSEUDOEPHEDRINE HYDROCHLORIDE AND CODEINE PHOSPHATE	CODEINE PHOSPHATE; PSEUDOEPHEDRINE HYDROCHLORIDE; TRIPROLIDINE HYDROCHLORIDE
PREDSULFAIR II	PREDNISOLONE ACETATE; SULFACETAMIDE SODIUM
ALLERFED	PSEUDOEPHEDRINE HYDROCHLORIDE; TRIPROLIDINE HYDROCHLORIDE
PROMETHAZINE W/ DEXTROMETHORPHAN	DEXTROMETHORPHAN HYDROBROMIDE; PROMETHAZINE HYDROCHLORIDE
PHERAZINE VC	PHENYLEPHRINE HYDROCHLORIDE; PROMETHAZINE HYDROCHLORIDE
PHERAZINE VC W/ CODEINE	CODEINE PHOSPHATE; PHENYLEPHRINE HYDROCHLORIDE; PROMETHAZINE HYDROCHLORIDE
NORCET	ACETAMINOPHEN; HYDROCODONE BITARTRATE
BANCAP	ACETAMINOPHEN; BUTALBITAL
ACETAMINOPHEN AND HYDROCODONE BITARTRATE	ACETAMINOPHEN; HYDROCODONE BITARTRATE
RESERPINE AND HYDROFLUMETHIAZIDE	HYDROFLUMETHIAZIDE; RESERPINE
PHERAZINE DM	DEXTROMETHORPHAN HYDROBROMIDE; PROMETHAZINE HYDROCHLORIDE
SEDAPAP	ACETAMINOPHEN; BUTALBITAL
HYDRA-ZIDE	HYDRALAZINE HYDROCHLORIDE; HYDROCHLOROTHIAZIDE
LOGEN	ATROPINE SULFATE; DIPHENOXYLATE HYDROCHLORIDE
BUCET	ACETAMINOPHEN; BUTALBITAL
TRIPROLIDINE AND PSEUDOEPHEDRINE HYDROCHLORIDES W/ CODEINE	CODEINE PHOSPHATE; PSEUDOEPHEDRINE HYDROCHLORIDE; TRIPROLIDINE HYDROCHLORIDE
TRIAD	ACETAMINOPHEN; BUTALBITAL; CAFFEINE
FEMCET	ACETAMINOPHEN; BUTALBITAL; CAFFEINE
MEDIGESIC PLUS	ACETAMINOPHEN; BUTALBITAL; CAFFEINE
BROMPHERIL	DEXBROMPHENIRAMINE MALEATE; PSEUDOEPHEDRINE SULFATE
MEPROBAMATE AND ASPIRIN	ASPIRIN; MEPROBAMATE
MEPRO-ASPIRIN	ASPIRIN; MEPROBAMATE
RESPORAL	DEXBROMPHENIRAMINE MALEATE; PSEUDOEPHEDRINE SULFATE
SYNALGOS-DC-A	ACETAMINOPHEN; CAFFEINE; DIHYDROCODEINE BITARTRATE
TRIAPRIN	ACETAMINOPHEN; BUTALBITAL
RENOCAL-76	DIATRIZOATE MEGLUMINE; DIATRIZOATE SODIUM
TYCOLET	ACETAMINOPHEN; HYDROCODONE BITARTRATE
TENCON	ACETAMINOPHEN; BUTALBITAL
AZDONE	ASPIRIN; HYDROCODONE BITARTRATE
HYDROCORTISONE ACETATE 1% AND PRAMOXINE HYDROCHLORIDE 1%	HYDROCORTISONE ACETATE; PRAMOXINE HYDROCHLORIDE
ALUMINUM HYDROXIDE AND MAGNESIUM TRISILICATE	ALUMINUM HYDROXIDE; MAGNESIUM TRISILICATE
U-CORT	HYDROCORTISONE ACETATE; UREA
POLOCAINE W/ LEVONORDEFRIN	LEVONORDEFRIN; MEPIVACAINE HYDROCHLORIDE
ESGIC	ACETAMINOPHEN; BUTALBITAL; CAFFEINE
ANEXSIA 7.5/650	ACETAMINOPHEN; HYDROCODONE BITARTRATE
VICODIN ES	ACETAMINOPHEN; HYDROCODONE BITARTRATE
ROXICET 5/500	ACETAMINOPHEN; OXYCODONE HYDROCHLORIDE
ALLAY	ACETAMINOPHEN; HYDROCODONE BITARTRATE
BUTAPAP	ACETAMINOPHEN; BUTALBITAL
AMLODIPINE BESYLATE AND VALSARTAN	AMLODIPINE BESYLATE; VALSARTAN
PEG-3350, POTASSIUM CHLORIDE, SODIUM BICARBONATE, SODIUM CHLORIDE	POLYETHYLENE GLYCOL 3350; POTASSIUM CHLORIDE; SODIUM BICARBONATE; SODIUM CHLORIDE
EMTRICITABINE; TENOFOVIR DISOPROXIL FUMARATE	EMTRICITABINE; TENOFOVIR DISOPROXIL FUMARATE
SYEDA	DROSPIRENONE; ETHINYL ESTRADIOL
PEG-3350, SODIUM SULFATE, SODIUM CHLORIDE, POTASSIUM CHLORIDE, SODIUM ASCORBATE AND ASCORBIC ACID	ASCORBIC ACID; POLYETHYLENE GLYCOL 3350; POTASSIUM CHLORIDE; SODIUM ASCORBATE; SODIUM CHLORIDE; SODIUM SULFATE
PROMETHAZINE HYDROCHLORIDE; CODEINE PHOSPHATE	PROMETHAZINE HYDROCHLORIDE; CODEINE PHOSPHATE
PEG 3350 AND ELECTROLYTES	POLYETHYLENE GLYCOL 3350; POTASSIUM CHLORIDE; SODIUM BICARBONATE; SODIUM CHLORIDE; SODIUM SULFATE ANHYDROUS
POLYETHYLENE GLYCOL 3350; SODIUM CHLORIDE; SODIUM BICARBONATE; POTASSIUM CHLORIDE; BISACODYL	POLYETHYLENE GLYCOL 3350; SODIUM CHLORIDE; SODIUM BICARBONATE; POTASSIUM CHLORIDE; BISACODYL
GILDESS 24 FE	ETHINYL ESTRADIOL; NORETHINDRONE ACETATE
LEVOFLOXACIN; DEXTROSE	LEVOFLOXACIN; DEXTROSE
ABACAVIR SULFATE, LAMIVUDINE AND ZIDOVUDINE	ABACAVIR SULFATE; LAMIVUDINE; ZIDOVUDINE
IBUPROFEN AND DIPHENHYDRAMINE HYDROCHLORIDE	DIPHENHYDRAMINE HYDROCHLORIDE; IBUPROFEN
AMLODIPINE AND OLMESARTAN MEDOXOMIL	AMLODIPINE BESYLATE; OLMESARTAN MEDOXOMIL
PIOGLITAZONE HYDROCHLORIDE AND METFORMIN HYDROCHLORIDE	METFORMIN HYDROCHLORIDE; PIOGLITAZONE HYDROCHLORIDE
EFAVIRENZ; EMTRICITABINE; TENOFOVIR DISOPROXIL FUMARATE	EFAVIRENZ;EMTRICITABINE;TENOFOVIR DISOPROXIL FUMARATE
ZYFREL	ACETAMINOPHEN; HYDROCODONE BITARTRATE
NORGESTIMATE; ETHINYL ESTRADIOL	NORGESTIMATE; ETHINYL ESTRADIOL
EMTRICITABINE AND TENOFOVIR DISOPROXIL FUMARATE	EMTRICITABINE; TENOFOVIR DISOPROXIL FUMARATE
MONO-LINYAH	ETHINYL ESTRADIOL; NORGESTIMATE
TRI-LINYAH	ETHINYL ESTRADIOL; NORGESTIMATE
BRIELLYN	ETHINYL ESTRADIOL; NORETHINDRONE
TRI-LO-LINYAH	NORGESTIMATE; ETHINYL ESTRADIOL
IMIPENEM AND CILASTATIN	CILASTATIN SODIUM; IMIPENEM
CANDESARTAN CILEXETIL AND HYDROCHLOROTHIAZIDE	CANDESARTAN CILEXETIL; HYDROCHLOROTHIAZIDE
POLYETHYLENE GLYCOL 3350 AND ELECTROLYTES	POLYETHYLENE GLYCOL 3350; POTASSIUM CHLORIDE; SODIUM BICARBONATE; SODIUM CHLORIDE; SODIUM SULFATE ANHYDROUS
SETLAKIN	ETHINYL ESTRADIOL; LEVONORGESTREL
LEVONEST	ETHINYL ESTRADIOL; LEVONORGESTREL
FALMINA	ETHINYL ESTRADIOL; LEVONORGESTREL
BETAMETHASONE ACETATE AND BETAMETHASONE SODIUM PHOSPHATE	BETAMETHASONE ACETATE; BETAMETHASONE SODIUM PHOSPHATE
SUMATRIPTAN; NAPROXEN SODIUM	SUMATRIPTAN; NAPROXEN SODIUM
CLENZ-LYTE	POLYETHYLENE GLYCOL 3350; POTASSIUM CHLORIDE; SODIUM BICARBONATE; SODIUM CHLORIDE; SODIUM SULFATE
TRI-ESTARYLLA	ETHINYL ESTRADIOL; NORGESTIMATE
ESTARYLLA	ETHINYL ESTRADIOL; NORGESTIMATE
IRBESARTAN; HYDROCHLOROTHIAZIDE	IRBESARTAN; HYDROCHLOROTHIAZIDE
SUMATRIPTAN AND NAPROXEN SODIUM	NAPROXEN SODIUM; SUMATRIPTAN SUCCINATE
DASETTA 7/7/7	ETHINYL ESTRADIOL; NORETHINDRONE
PHILITH	ETHINYL ESTRADIOL; NORETHINDRONE
DASETTA 1/35	ETHINYL ESTRADIOL; NORETHINDRONE
GUAIFENESIN AND DEXTROMETHORPHAN HYDROBROMIDE	DEXTROMETHORPHAN HYDROBROMIDE; GUAIFENESIN
GUAIFENESIN AND PSEUDOEPHEDRINE HYDROCHLORIDE	GUAIFENESIN; PSEUDOEPHEDRINE HYDROCHLORIDE
TELMISARTAN; HYDROCHLOROTHIAZIDE	TELMISARTAN; HYDROCHLOROTHIAZIDE
BRIMONIDINE TARTRATE; TIMOLOL MALEATE	BRIMONIDINE TARTRATE; TIMOLOL MALEATE
ELINEST	ETHINYL ESTRADIOL; NORGESTREL
BUPRENORPHINE HYDROCHLORIDE AND NALOXONE HYDROCHLORIDE	BUPRENORPHINE HYDROCHLORIDE; NALOXONE HYDROCHLORIDE
WERA	ETHINYL ESTRADIOL; NORETHINDRONE
ATOVAQUONE AND PROGUANIL HYDROCHLORIDE	ATOVAQUONE; PROGUANIL HYDROCHLORIDE
EFAVIRENZ, EMTRICITABINE, AND TENOFOVIR DISOPROXIL FUMARATE	EFAVIRENZ; EMTRICITABINE; TENOFOVIR DISOPROXIL FUMARATE
TRI-LO-ESTARYLLA	ETHINYL ESTRADIOL; NORGESTIMATE
PIMTREA	DESOGESTREL; ETHINYL ESTRADIOL
VIORELE	DESOGESTREL; ETHINYL ESTRADIOL
TELMISARTAN AND HYDROCHLOROTHIAZIDE	HYDROCHLOROTHIAZIDE; TELMISARTAN
BLISOVI 24 FE	ETHINYL ESTRADIOL; NORETHINDRONE ACETATE
KURVELO	ETHINYL ESTRADIOL; LEVONORGESTREL
MARLISSA	ETHINYL ESTRADIOL; LEVONORGESTREL
LARIN FE 1.5/30	ETHINYL ESTRADIOL; NORETHINDRONE ACETATE
LARIN FE 1/20	ETHINYL ESTRADIOL; NORETHINDRONE ACETATE
DAYSEE	ETHINYL ESTRADIOL; LEVONORGESTREL
HYDROCODONE POLISTIREX AND CHLORPHENIRAMINE POLISTIREX	CHLORPHENIRAMINE POLISTIREX; HYDROCODONE POLISTIREX
ALYACEN 1/35	ETHINYL ESTRADIOL; NORETHINDRONE
ALYACEN 7/7/7	ETHINYL ESTRADIOL; NORETHINDRONE
ALYACEN 777	NORETHINDRONE; ETHINYL ESTRADIOL
VALSARTAN; HYDROCHLOROTHIAZIDE	VALSARTAN; HYDROCHLOROTHIAZIDE
HYDROCODONE POLISTIREX AND CHLORPHENIRAMNE POLISTIREX	CHLORPHENIRAMINE POLISTIREX; HYDROCODONE POLISTIREX
PROMETHAZINE HYDROCHLORIDE; DEXTROMETHORPHAN HYDROBROMIDE	PROMETHAZINE HYDROCHLORIDE; DEXTROMETHORPHAN HYDROBROMIDE
ETHINYL ESTRADIOL AND LEVONORGESTREL	ETHINYL ESTRADIOL; LEVONORGESTREL
AMTURNIDE	ALISKIREN HEMIFUMARATE; AMLODIPINE BESYLATE; HYDROCHLOROTHIAZIDE
CONTRAVE	BUPROPION HYDROCHLORIDE; NALTREXONE HYDROCHLORIDE
EZETIMIBE; SIMVASTATIN	EZETIMIBE; SIMVASTATIN
LIPTRUZET	ATORVASTATIN CALCIUM; EZETIMIBE
DICLOFENAC SODIUM AND MISOPROSTOL	DICLOFENAC SODIUM; MISOPROSTOL
CALCIPOTRIENE AND BETAMETHASONE DIPROPIONATE	BETAMETHASONE DIPROPIONATE; CALCIPOTRIENE
TRIBENZOR	AMLODIPINE BESYLATE; HYDROCHLOROTHIAZIDE; OLMESARTAN MEDOXOMIL
LANSOPRAZOLE, AMOXICILLIN AND CLARITHROMYCIN	AMOXICILLIN; CLARITHROMYCIN; LANSOPRAZOLE
LAMIVUDINE, NEVIRAPINE, AND STAVUDINE	LAMIVUDINE; NEVIRAPINE;  STAVUDINE
AMLODIPINE BESYLATE, VALSARTAN AND HYDROCHLOROTHIAZIDE	AMLODIPINE BESYLATE; HYDROCHLOROTHIAZIDE; VALSARTAN
AMLODIPINE BESYLATE AND ATORVASTATIN CALCIUM	AMLODIPINE BESYLATE; ATORVASTATIN CALCIUM
LAMIVUDINE; TENOFOVIR DISOPROXIL FUMARATE	LAMIVUDINE; TENOFOVIR DISOPROXIL FUMARATE
REPAGLINIDE AND METFORMIN HYDROCHLORIDE	METFORMIN HYDROCHLORIDE; REPAGLINIDE
PERIKABIVEN IN PLASTIC CONTAINER	AMINO ACIDS; CALCIUM CHLORIDE; DEXTROSE; MAGNESIUM SULFATE; POTASSIUM CHLORIDE; SODIUM ACETATE; SODIUM GLYCEROPHOSPHATE; SOYBEAN OIL
KABIVEN IN PLASTIC CONTAINER	AMINO ACIDS; CALCIUM CHLORIDE; DEXTROSE; MAGNESIUM SULFATE; POTASSIUM CHLORIDE; SODIUM ACETATE; SODIUM GLYCEROPHOSPHATE; SOYBEAN OIL
KOMBIGLYZE XR	METFORMIN HYDROCHLORIDE; SAXAGLIPTIN HYDROCHLORIDE
LAMIVUDINE/NEVIRAPINE/ZIDOVUDINE TABLETS	Lamivudine; Nevirapine; Zidovudine
CANDESARTAN CILEXETIL; HYDROCHLOROTHIAZIDE	CANDESARTAN CILEXETIL; HYDROCHLOROTHIAZIDE
EZETIMIBE AND SIMVASTATIN	EZETIMIBE; SIMVASTATIN
XULANE	ETHINYL ESTRADIOL; NORELGESTROMIN
PROMETHAZINE HYDROCHLORIDE,PHENYLEPHRINE HYDROCHLORIDE W/CODEINE PHOSPHATE	CODEINE PHOSPHATE; PHENYLEPHRINE HYDROCHLORIDE; PROMETHAZINE HYDROCHLORIDE
PIOGLITAZONE HYDROCHLORIDE AND GLIMEPIRIDE	GLIMEPIRIDE; PIOGLITAZONE HYDROCHLORIDE
VIENVA	ETHINYL ESTRADIOL; LEVONORGESTREL
JENTADUETO	LINAGLIPTIN; METFORMIN HYDROCHLORIDE
NITHIODOTE	SODIUM NITRITE; SODIUM THIOSULFATE
IRBESARTAN HYDROCHLOROTHIAZIDE	HYDROCHLOROTHIAZIDE; IRBESARTAN
PIRMELLA 7/7/7	ETHINYL ESTRADIOL; NORETHINDRONE
PIRMELLA 1/35	ETHINYL ESTRADIOL; NORETHINDRONE
BLISOVI FE 1/20	ETHINYL ESTRADIOL; NORETHINDRONE ACETATE
BLISOVI FE 1.5/30	ETHINYL ESTRADIOL; NORETHINDRONE ACETATE
TELMISARTAN AND AMLODIPINE	AMLODIPINE BESYLATE; TELMISARTAN
HYDROCHLOROTHIAZIDE; IRBESARTAN	HYDROCHLOROTHIAZIDE; IRBESARTAN
BUPRENORPHINE HYDROCHLORIDE AND NALOXONE HYDROCHLORIDE 	BUPRENORPHINE HYDROCHLORIDE; NALOXONE HYDROCHLORIDE
NIKKI	DROSPIRENONE; ETHINYL ESTRADIOL
ULTACAN FORTE	ARTICAINE HYDROCHLORIDE; EPINEPHRINE BITARTRATE
ULTACAN	ARTICAINE HYDROCHLORIDE; EPINEPHRINE BITARTRATE
NORGESTREL AND ETHINYL ESTRADIOL	ETHINYL ESTRADIOL; NORGESTREL
VYFEMLA	ETHINYL ESTRADIOL; NORETHINDRONE
ENSKYCE	DESOGESTREL; ETHINYL ESTRADIOL
YAELA	DROSPIRENONE; ETHINYL ESTRADIOL
MELAMISA	DROSPIRENONE; ETHINYL ESTRADIOL
PEG-3350, POTASSIUM CHLORIDE, SODIUM BICARBONATE, SODIUM CHLORIDE 	POLYETHYLENE GLYCOL 3350; POTASSIUM CHLORIDE; SODIUM BICARBONATE; SODIUM CHLORIDE
COMPLERA	EMTRICITABINE; RILPIVIRINE HYDROCHLORIDE; TENOFOVIR DISOPROXIL FUMARATE
KEMEYA	DROSPIRENONE; ETHINYL ESTRADIOL
LAMIVUDINE; TENOFOVIR DISOPROXIL FUMARATE; NEVIRAPINE	LAMIVUDINE; TENOFOVIR DISOPROXIL FUMARATE; NEVIRAPINE
PEG-3350, SODIUM CHLORIDE, SODIUM BICARBONATE, POTASSIUM CHLORIDE AND BISACODYL	BISACODYL; POLYETHYLENE GLYCOL 3350; POTASSIUM CHLORIDE; SODIUM BICARBONATE; SODIUM CHLORIDE
BEKYREE	DESOGESTREL; ETHINYL ESTRADIOL
DYMISTA	AZELASTINE HYDROCHLORIDE; FLUTICASONE PROPIONATE
JANUMET XR	METFORMIN HYDROCHLORIDE; SITAGLIPTIN PHOSPHATE
EDARBYCLOR	AZILSARTAN KAMEDOXOMIL; CHLORTHALIDONE
JUVISYNC	SIMVASTATIN; SITAGLIPTIN PHOSPHATE
ESTRADIOL VALERATE AND DIENOGEST	DIENOGEST; ESTRADIOL VALERATE
SITAGLIPTIN PHOSPHATE; METFORMIN HYDROCHLORIDE	SITAGLIPTIN PHOSPHATE;METFORMIN HYDROCHLORIDE
SITAGLIPTIN; METFORMIN HYDROCHLORIDE	SITAGLIPTIN; METFORMIN HYDROCHLORIDE
NAPROXEN AND ESOMEPRAZOLE MAGNESIUM	ESOMEPRAZOLE MAGNESIUM; NAPROXEN
OLMESARTAN MEDOXOMIL, AMLODIPINE AND HYDROCHLOROTHIAZIDE	AMLODIPINE BESYLATE; HYDROCHLOROTHIAZIDE; OLMESARTAN MEDOXOMIL
ELIFEMME	ETHINYL ESTRADIOL; LEVONORGESTREL
DUTASTERIDE AND TAMSULOSIN HYDROCHLORIDE	DUTASTERIDE; TAMSULOSIN HYDROCHLORIDE
SODIUM SULFATE, POTASSIUM SULFATE AND MAGNESIUM SULFATE 	MAGNESIUM SULFATE; POTASSIUM SULFATE; SODIUM SULFATE
PREPOPIK	CITRIC ACID; MAGNESIUM OXIDE; SODIUM PICOSULFATE
CLINDAMYCIN PHOSPHATE AND TRETINOIN	CLINDAMYCIN PHOSPHATE; TRETINOIN
BISMUTH SUBSALICYLATE, METRONIDAZOLE AND TETRACYCLINE HYDROCHLORIDE	BISMUTH SUBSALICYLATE; METRONIDAZOLE; TETRACYCLINE HYDROCHLORIDE
COSOPT PF	DORZOLAMIDE HYDROCHLORIDE; TIMOLOL MALEATE
VOLNEA	DESOGESTREL; ETHINYL ESTRADIOL
ISIBLOOM	DESOGESTREL; ETHINYL ESTRADIOL
CERINTA	ETHINYL ESTRADIOL; LEVONORGESTREL
DEXTROMETHORPHAN HYDROBROMIDE AND QUINIDINE SULFATE	DEXTROMETHORPHAN HYDROBROMIDE;QUINIDINE SULFATE
BROMPHENIRAMINE MALEATE, PSEUDOEPHEDRINE HYDROCHLORIDE AND DEXTROMETHORPHAN HYDROBROMIDE	BROMPHENIRAMINE MALEATE; DEXTROMETHORPHAN HYDROBROMIDE; PSEUDOEPHEDRINE HYDROCHLORIDE
SYLEVIA	ETHINYL ESTRADIOL; LEVONORGESTREL
LARIN 24 FE	ETHINYL ESTRADIOL; NORETHINDRONE ACETATE
LARIN 1/20	ETHINYL ESTRADIOL; NORETHINDRONE ACETATE
LARIN 1.5/30	ETHINYL ESTRADIOL; NORETHINDRONE ACETATE
ESTRADIOL VALERATE; ESTRADIOL VALERATE; DIENOGEST	ESTRADIOL VALERATE; ESTRADIOL VALERATE; DIENOGEST
STRIBILD	COBICISTAT; ELVITEGRAVIR; EMTRICITABINE; TENOFOVIR DISOPROXIL FUMARATE
MAGNESIUM SULFATE ANHYDROUS; POTASSIUM SULFATE; SODIUM SULFATE	MAGNESIUM SULFATE ANHYDROUS; POTASSIUM SULFATE; SODIUM SULFATE
LO-BLISOVI FE	NORETHINDRONE ACETATE;ETHINYL ESTRADIOL;FERROUS FUMARATE
ASHLYNA	ETHINYL ESTRADIOL; LEVONORGESTREL
IBUPROFEN AND PHENYLEPHRINE HYDROCHLORIDE	IBUPROFEN; PHENYLEPHRINE HYDROCHLORIDE
RYTARY	CARBIDOPA; LEVODOPA
RYZODEG 70/30	INSULIN ASPART; INSULIN DEGLUDEC
AMABELZ	ESTRADIOL; NORETHINDRONE ACETATE
CYCLAFEM 0.5/35	ETHINYL ESTRADIOL; NORETHINDRONE
KAZANO	ALOGLIPTIN BENZOATE; METFORMIN HYDROCHLORIDE
LERIBANE	ETHINYL ESTRADIOL; NORETHINDRONE ACETATE
KAITLIB FE	ETHINYL ESTRADIOL; NORETHINDRONE
ALLZITAL	ACETAMINOPHEN; BUTALBITAL
OXYCODONE HYDROCHLORIDE AND ACETAMINOPHEN	ACETAMINOPHEN; OXYCODONE HYDROCHLORIDE
DROSPIRENONE, ETHINYL ESTRADIOL AND LEVOMEFOLATE CALCIUM	DROSPIRENONE; ETHINYL ESTRADIOL; LEVOMEFOLATE CALCIUM
SUCLEAR	MAGNESIUM SULFATE; POLYETHYLENE GLYCOL 3350; POTASSIUM CHLORIDE; POTASSIUM SULFATE; SODIUM BICARBONATE; SODIUM CHLORIDE; SODIUM SULFATE
MINASTRIN 24 FE	ETHINYL ESTRADIOL; NORETHINDRONE ACETATE
LUPANETA PACK	LEUPROLIDE ACETATE; NORETHINDRONE ACETATE
JAIMIESS	ETHINYL ESTRADIOL; LEVONORGESTREL
ADAPALENE AND BENZOYL PEROXIDE	ADAPALENE; BENZOYL PEROXIDE
HYDROCODONE BITARTRATE, CHLORPHENIRAMINE MALEATE AND PSEUDOEPHEDRINE HYDROCHLORIDE	CHLORPHENIRAMINE MALEATE; HYDROCODONE BITARTRATE; PSEUDOEPHEDRINE HYDROCHLORIDE
HYDROCODONE BITARTRATE AND PSEUDOEPHEDRINE HYDROCHLORIDE	HYDROCODONE BITARTRATE; PSEUDOEPHEDRINE HYDROCHLORIDE
DUOPA	CARBIDOPA; LEVODOPA
ANORO ELLIPTA	UMECLIDINIUM BROMIDE; VILANTEROL TRIFENATATE
XARTEMIS XR	ACETAMINOPHEN; OXYCODONE HYDROCHLORIDE
QUARTETTE	ETHINYL ESTRADIOL; LEVONORGESTREL
EFAVIRENZ, LAMIVUDINE, AND TENOFOVIR DISOPROXIL FUMARATE	EFAVIRENZ;LAMIVUDINE;TENOFOVIR DISOPROXIL FUMARATE
SODIUM SULFATE; POTASSIUM SULFATE; MAGNESIUM SULFATE	SODIUM SULFATE;POTASSIUM SULFATE;MAGNESIUM SULFATE
METFORMIN HYDROCHLORIDE AND  SITAGLIPTIN PHOSPHATE	METFORMIN HYDROCHLORIDE; SITAGLIPTIN PHOSPHATE
ESOMEPRAZOLE MAGNESIUM; NAPROXEN	ESOMEPRAZOLE MAGNESIUM;NAPROXEN
ACETAMINOPHEN, CAFFEINE AND DIHYDROCODEINE BITARTRATE	ACETAMINOPHEN; CAFFEINE; DIHYDROCODEINE BITARTRATE
FYAVOLV	ETHINYL ESTRADIOL; NORETHINDRONE ACETATE
ZUBSOLV	BUPRENORPHINE HYDROCHLORIDE; NALOXONE HYDROCHLORIDE
SIMBRINZA	BRIMONIDINE TARTRATE; BRINZOLAMIDE
BREO ELLIPTA	FLUTICASONE FUROATE; VILANTEROL TRIFENATATE
VITUZ	CHLORPHENIRAMINE MALEATE; HYDROCODONE BITARTRATE
ABACAVIR AND LAMIVUDINE	ABACAVIR; LAMIVUDINE
INVOKAMET	CANAGLIFLOZIN; METFORMIN HYDROCHLORIDE
BUPRENORPHINE HYDROCHLORIDE; NALOXONE HYDROCHLORIDE	BUPRENORPHINE HYDROCHLORIDE; NALOXONE HYDROCHLORIDE
TAYTULLA	ETHINYL ESTRADIOL; NORETHINDRONE ACETATE
CLINOLIPID 20%	OLIVE OIL; SOYBEAN OIL
COLPREP KIT	MAGNESIUM SULFATE; POTASSIUM SULFATE; SODIUM SULFATE
HYDROCODONE BITARTRATE, CHLORPHENIRAMINE MALEATE AND PSEUDOEPHEDRINE HYDROCHLORIDE 	CHLORPHENIRAMINE MALEATE; HYDROCODONE BITARTRATE; PSEUDOEPHEDRINE HYDROCHLORIDE
LO MINASTRIN FE	ETHINYL ESTRADIOL; NORETHINDRONE ACETATE
ETHYNODIOL DIACETATE AND ETHINYL ESTRADIOL	ETHINYL ESTRADIOL; ETHYNODIOL DIACETATE
TREZIX	ACETAMINOPHEN; CAFFEINE; DIHYDROCODEINE BITARTRATE
PRESTALIA	AMLODIPINE BESYLATE; PERINDOPRIL ARGININE
NORETHINDRONE ACETATE AND ETHINYL ESTRADIOL AND ETHINYL ESTRADIOL AND FERROUS FUMARATE	ETHINYL ESTRADIOL; NORETHINDRONE ACETATE
YOSPRALA	ASPIRIN; OMEPRAZOLE
ALEVE PM	DIPHENHYDRAMINE HYDROCHLORIDE; NAPROXEN SODIUM
OMIDRIA	KETOROLAC TROMETHAMINE; PHENYLEPHRINE HYDROCHLORIDE
PREZCOBIX	COBICISTAT; DARUNAVIR ETHANOLATE
LOPINAVIR AND RITONAVIR	LOPINAVIR; RITONAVIR
HYDROCHLOROTHIAZIDE; VALSARTAN	HYDROCHLOROTHIAZIDE; VALSARTAN
TRI-MILI	ETHINYL ESTRADIOL; NORGESTIMATE
MILI	ETHINYL ESTRADIOL; NORGESTIMATE
OBREDON	GUAIFENESIN; HYDROCODONE BITARTRATE
ATAZANAVIR SULFATE; RITONAVIR	ATAZANAVIR SULFATE; RITONAVIR
TRIUMEQ	ABACAVIR SULFATE; DOLUTEGRAVIR SODIUM; LAMIVUDINE
LAMIVUDINE, NEVIRAPINE AND ZIDOVUDINE	LAMIVUDINE; NEVIRAPINE; ZIDOVUDINE
BUNAVAIL	BUPRENORPHINE HYDROCHLORIDE; NALOXONE HYDROCHLORIDE
XIGDUO XR	DAPAGLIFLOZIN; METFORMIN HYDROCHLORIDE
AKYNZEO	FOSNETUPITANT CHLORIDE HYDROCHLORIDE; PALONOSETRON HYDROCHLORIDE
CITRIC ACID; MAGNESIUM OXIDE; SODIUM PICOSULFATE	CITRIC ACID; MAGNESIUM OXIDE; SODIUM PICOSULFATE
TRI-LO-MILI	ETHINYL ESTRADIOL; NORGESTIMATE
TARGINIQ	NALOXONE HYDROCHLORIDE; OXYCODONE HYDROCHLORIDE
DOXYLAMINE SUCCINATE AND PYRIDOXINE HYDROCHLORIDE	DOXYLAMINE SUCCINATE; PYRIDOXINE HYDROCHLORIDE
HARVONI	LEDIPASVIR; SOFOSBUVIR
EFAVIRENZ; LAMIVUDINE; TENOFOVIR DISOPROXIL FUMARATE	EFAVIRENZ;LAMIVUDINE;TENOFOVIR DISOPROXIL FUMARATE
INVOKAMET XR	CANAGLIFLOZIN; METFORMIN HYDROCHLORIDE
SODIUM PHENYLACETATE AND SODIUM BENZOATE	SODIUM BENZOATE; SODIUM PHENYLACETATE
SAXAGLIPTIN;METFORMIN HYDROCHLORIDE	SAXAGLIPTIN;METFORMIN HYDROCHLORIDE
FAYOSIM	ETHINYL ESTRADIOL; LEVONORGESTREL
DROSPIRENONE, ETHINYL ESTRADIOL AND LEVOMEFOLATE CALCIUM 	DROSPIRENONE; ETHINYL ESTRADIOL; LEVOMEFOLATE CALCIUM
TYDEMY	DROSPIRENONE; ETHINYL ESTRADIOL; LEVOMEFOLATE CALCIUM
ORKAMBI	IVACAFTOR; LUMACAFTOR
ATAZANAVIR SULFATE;RITONAVIR;LAMIVUDINE;ZIDOVUDINE	ATAZANAVIR SULFATE;RITONAVIR;LAMIVUDINE;ZIDOVUDINE
EMTRICITABINE;TENOFOVIR DISOPROXIL FUMARATE;NEVIRAPINE	EMTRICITABINE;TENOFOVIR DISOPROXIL FUMARATE;NEVIRAPINE
GLYXAMBI	EMPAGLIFLOZIN; LINAGLIPTIN
EZETIMIBE AND ATORVASTATIN CALCIUM	ATORVASTATIN CALCIUM; EZETIMIBE
SYNJARDY	EMPAGLIFLOZIN; METFORMIN HYDROCHLORIDE
DEXTROAMP SACCHARATE, AMP ASPARTATE, DETROAMP SULFATE AND AMP SULFATE	AMPHETAMINE ASPARTATE; AMPHETAMINE SULFATE; DEXTROAMPHETAMINE SACCHARATE; DEXTROAMPHETAMINE SULFATE
ETHINYL ESTRADIOL; LEVONORGESTREL	ETHINYL ESTRADIOL; LEVONORGESTREL
MIBELAS 24 FE	ETHINYL ESTRADIOL; NORETHINDRONE ACETATE
BYVALSON	NEBIVOLOL HYDROCHLORIDE; VALSARTAN
DEXTROAMPHETAMINE SACCHARATE; AMPHETAMINE ASPARTATE MONOHYDRATE; DEXTROAMPHETAMINE SULFATE; AMPHETAMINE SULFATE	DEXTROAMPHETAMINE SACCHARATE;AMPHETAMINE ASPARTATE MONOHYDRATE;DEXTROAMPHETAMINE SULFATE;AMPHETAMINE SULFATE
TUXARIN ER	CHLORPHENIRAMINE MALEATE; CODEINE PHOSPHATE
EVOTAZ	ATAZANAVIR SULFATE; COBICISTAT
HYDROCODONE BITARTRATE AND CHLORPHENIRAMINE MALEATE	CHLORPHENIRAMINE MALEATE; HYDROCODONE BITARTRATE
NAMZARIC	DONEPEZIL HYDROCHLORIDE; MEMANTINE HYDROCHLORIDE
AVYCAZ	AVIBACTAM SODIUM; CEFTAZIDIME
DUTREBIS	LAMIVUDINE; RALTEGRAVIR POTASSIUM
HAILEY FE 1/20	ETHINYL ESTRADIOL; NORETHINDRONE ACETATE
VIEKIRA PAK (COPACKAGED)	DASABUVIR SODIUM ; OMBITASVIR; PARITAPREVIR; RITONAVIR
STIOLTO RESPIMAT	OLODATEROL HYDROCHLORIDE; TIOTROPIUM BROMIDE
ZERBAXA	CEFTOLOZANE SULFATE; TAZOBACTAM SODIUM
ICLEVIA	ETHINYL ESTRADIOL; LEVONORGESTREL
SIMPESSE	ETHINYL ESTRADIOL; LEVONORGESTREL
LO SIMPESSE	ETHINYL ESTRADIOL; LEVONORGESTREL
AYUNA	ETHINYL ESTRADIOL; LEVONORGESTREL
AFIRMELLE	ETHINYL ESTRADIOL; LEVONORGESTREL
PHOXILLUM BK 4/2.5 IN PLASTIC CONTAINER	CALCIUM CHLORIDE; MAGNESIUM CHLORIDE; POTASSIUM CHLORIDE; SODIUM BICARBONATE; SODIUM CHLORIDE; SODIUM PHOSPHATE
PHOXILLUM B22K 4/0 IN PLASTIC CONTAINER	CALCIUM CHLORIDE; MAGNESIUM CHLORIDE; POTASSIUM CHLORIDE; SODIUM BICARBONATE; SODIUM CHLORIDE; SODIUM PHOSPHATE
NYLIA 7/7/7	ETHINYL ESTRADIOL; NORETHINDRONE
CYONANZ	ETHINYL ESTRADIOL; NORETHINDRONE
NYLIA 1/35	ETHINYL ESTRADIOL; NORETHINDRONE
KALLIGA	DESOGESTREL; ETHINYL ESTRADIOL
ACETAMINOPHEN; OXYCODONE HYDROCHLORIDE	ACETAMINOPHEN; OXYCODONE HYDROCHLORIDE
BENZOYL PEROXIDE; CLINDAMYCIN PHOSPHATE	BENZOYL PEROXIDE;CLINDAMYCIN PHOSPHATE
ABACAVIR; LAMIVUDINE	ABACAVIR;LAMIVUDINE
AUROVELA 24 FE	ETHINYL ESTRADIOL; NORETHINDRONE ACETATE
AUROVELA FE 1/20	ETHINYL ESTRADIOL; NORETHINDRONE ACETATE
AUROVELA 1/20	ETHINYL ESTRADIOL; NORETHINDRONE ACETATE
NEXESTA FE	ETHINYL ESTRADIOL; NORETHINDRONE
GENVOYA	COBICISTAT; ELVITEGRAVIR; EMTRICITABINE; TENOFOVIR ALAFENAMIDE FUMARATE
AUROVELA FE 1.5/30	ETHINYL ESTRADIOL; NORETHINDRONE ACETATE
AUROVELA 1.5/30	ETHINYL ESTRADIOL; NORETHINDRONE ACETATE
ENSTILAR	BETAMETHASONE DIPROPIONATE; CALCIPOTRIENE
NAPROXEN SODIUM AND DIPHENHYDRAMINE HYDROCHLORIDE	DIPHENHYDRAMINE HYDROCHLORIDE; NAPROXEN SODIUM
ENTRESTO	SACUBITRIL; VALSARTAN
TROXYCA ER	NALTREXONE HYDROCHLORIDE; OXYCODONE HYDROCHLORIDE
SMOFLIPID 20%	FISH OIL; MEDIUM CHAIN TRIGLYCERIDES; OLIVE OIL; SOYBEAN OIL
AZELASTINE HYDROCHLORIDE AND FLUTICASONE PROPIONATE	AZELASTINE HYDROCHLORIDE; FLUTICASONE PROPIONATE
TUZISTRA XR	CHLORPHENIRAMINE POLISTIREX; CODEINE POLISTIREX
EPIDUO FORTE	ADAPALENE; BENZOYL PEROXIDE
UTIBRON	GLYCOPYRROLATE ; INDACATEROL MALEATE
TECHNIVIE	OMBITASVIR; PARITAPREVIR; RITONAVIR
LONSURF	TIPIRACIL HYDROCHLORIDE; TRIFLURIDINE
JENTADUETO XR	LINAGLIPTIN; METFORMIN HYDROCHLORIDE
KOVANAZE	OXYMETAZOLINE HYDROCHLORIDE; TETRACAINE HYDROCHLORIDE
CASSIPA	BUPRENORPHINE HYDROCHLORIDE; NALOXONE HYDROCHLORIDE
XTRELUS	GUAIFENESIN; HYDROCODONE BITARTRATE
NORETHINDRONE ACETATE; ETHINYL ESTRADIOL; ETHINYL ESTRADIOL; FERROUS FUMARATE	NORETHINDRONE ACETATE;ETHINYL ESTRADIOL;ETHINYL ESTRADIOL;FERROUS FUMARATE
MYXREDLIN	INSULIN HUMAN;SODIUM CHLORIDE
DESCOVY	EMTRICITABINE; TENOFOVIR ALAFENAMIDE FUMARATE
OTOVEL	CIPROFLOXACIN HYDROCHLORIDE; FLUOCINOLONE ACETONIDE
SYMFI LO	EFAVIRENZ; LAMIVUDINE; TENOFOVIR DISOPROXIL FUMARATE
ROCKLATAN	LATANOPROST; NETARSUDIL DIMESYLATE
ZEPATIER	ELBASVIR; GRAZOPREVIR
SOLUPREP	CHLORHEXIDINE GLUCONATE; ISOPROPYL ALCOHOL
BEVESPI AEROSPHERE	FORMOTEROL FUMARATE; GLYCOPYRROLATE
MEMANTINE HYDROCHLORIDE AND DONEPEZIL HYDROCHLORIDE	DONEPEZIL HYDROCHLORIDE; MEMANTINE HYDROCHLORIDE
EPCLUSA	SOFOSBUVIR; VELPATASVIR
ODEFSEY	EMTRICITABINE; RILPIVIRINE HYDROCHLORIDE; TENOFOVIR ALAFENAMIDE FUMARATE
LINAGLIPTIN; METFORMIN HYDROCHLORIDE	LINAGLIPTIN;METFORMIN HYDROCHLORIDE
LINAGLIPTIN AND METFORMIN HYDROCHLORIDE	LINAGLIPTIN; METFORMIN HYDROCHLORIDE
EMTRICITABINE;RILPIVIRINE;TENOFOVIR DISOPROXIL FUMARATE	EMTRICITABINE;RILPIVIRINE;TENOFOVIR DISOPROXIL FUMARATE
METFORMIN HYDROCHLORIDE AND SITAGLIPTIN PHOSPHATE	METFORMIN HYDROCHLORIDE;SITAGLIPTIN PHOSPHATE 
ALTAFLUOR BENOX	BENOXINATE HYDROCHLORIDE; FLUORESCEIN SODIUM
XULTOPHY 100/3.6	INSULIN DEGLUDEC; LIRAGLUTIDE
BALCOLTRA	ETHINYL ESTRADIOL; LEVONORGESTREL
VIEKIRA XR	DASABUVIR SODIUM; OMBITASVIR; PARITAPREVIR; RITONAVIR
APADAZ	ACETAMINOPHEN; BENZHYDROCODONE HYDROCHLORIDE
SYNJARDY XR	EMPAGLIFLOZIN; METFORMIN HYDROCHLORIDE
LO LARIN FE	ETHINYL ESTRADIOL; NORETHINDRONE ACETATE
DONEPEZIL HYDROCHLORIDE AND MEMANTINE HYDROCHLORIDE	DONEPEZIL HYDROCHLORIDE; MEMANTINE HYDROCHLORIDE
SOLIQUA 100/33	INSULIN GLARGINE; LIXISENATIDE
AIRDUO RESPICLICK	FLUTICASONE PROPIONATE; SALMETEROL XINAFOATE
WIXELA INHUB	FLUTICASONE PROPIONATE; SALMETEROL XINAFOATE
HAILEY FE 1.5/30	ETHINYL ESTRADIOL; NORETHINDRONE ACETATE
QTERN	DAPAGLIFLOZIN; SAXAGLIPTIN HYDROCHLORIDE
VOSEVI	SOFOSBUVIR; VELPATASVIR; VOXILAPREVIR
DUZALLO	ALLOPURINOL; LESINURAD
HAILEY 1.5/30	ETHINYL ESTRADIOL; NORETHINDRONE ACETATE
DUOBRII	HALOBETASOL PROPIONATE; TAZAROTENE
PLENVU	ASCORBIC ACID; POLYETHYLENE GLYCOL 3350; POTASSIUM CHLORIDE; SODIUM ASCORBATE; SODIUM CHLORIDE; SODIUM SULFATE
MAVYRET	GLECAPREVIR; PIBRENTASVIR
VYXEOS	CYTARABINE; DAUNORUBICIN 
ZUMANDIMINE	DROSPIRENONE; ETHINYL ESTRADIOL
TRELEGY ELLIPTA	FLUTICASONE FUROATE; UMECLIDINIUM BROMIDE; VILANTEROL TRIFENATATE
MALMOREDE	ETHINYL ESTRADIOL; ETHYNODIOL DIACETATE
LO-MALMOREDE	ETHINYL ESTRADIOL; ETHYNODIOL DIACETATE
CLENPIQ	CITRIC ACID; MAGNESIUM OXIDE; SODIUM PICOSULFATE
ANNOVERA	ETHINYL ESTRADIOL; SEGESTERONE ACETATE
LO-ZUMANDIMINE	DROSPIRENONE; ETHINYL ESTRADIOL
BONJESTA	DOXYLAMINE SUCCINATE; PYRIDOXINE HYDROCHLORIDE
DOLUTEGRAVIR, LAMIVUDINE, AND TENOFOVIR DISOPROXIL FUMARATE	DOLUTEGRAVIR;LAMIVUDINE;TENOFOVIR DISOPROXIL FUMARATE
VABOMERE	MEROPENEM; VABORBACTAM
STEGLUJAN	ERTUGLIFLOZIN; SITAGLIPTIN PHOSPHATE
SEGLUROMET	ERTUGLIFLOZIN; METFORMIN HYDROCHLORIDE
KISQALI FEMARA CO-PACK (COPACKAGED)	LETROZOLE; RIBOCICLIB SUCCINATE
CONSENSI	AMLODIPINE BESYLATE; CELECOXIB
AMPHETAMINE ASPARTATE; AMPHETAMINE SULFATE; DEXTROAMPHETAMINE SACCHARATE; DEXTROAMPHETAMINE SULFATE	AMPHETAMINE ASPARTATE;AMPHETAMINE SULFATE;DEXTROAMPHETAMINE SACCHARATE;DEXTROAMPHETAMINE SULFATE
BIJUVA	ESTRADIOL; PROGESTERONE
ALOGLIPTIN; METFORMIN HYDROCHLORIDE	ALOGLIPTIN; METFORMIN HYDROCHLORIDE
JULUCA	DOLUTEGRAVIR SODIUM; RILPIVIRINE HYDROCHLORIDE
BIKTARVY	BICTEGRAVIR SODIUM; EMTRICITABINE; TENOFOVIR ALAFENAMIDE FUMARATE
SYMTUZA	COBICISTAT; DARUNAVIR ETHANOLATE; EMTRICITABINE; TENOFOVIR ALAFENAMIDE FUMARATE
SYMDEKO (COPACKAGED)	IVACAFTOR; IVACAFTOR, TEZACAFTOR
DUAKLIR PRESSAIR	ACLIDINIUM BROMIDE; FORMOTEROL FUMARATE
DOLUTEGRAVIR; LAMIVUDINE; TENOFOVIR DISOPROXIL FUMARATE	DOLUTEGRAVIR;LAMIVUDINE;TENOFOVIR DISOPROXIL FUMARATE
DELSTRIGO	DORAVIRINE; LAMIVUDINE; TENOFOVIR DISOPROXIL FUMARATE
QTERNMET XR	DAPAGLIFLOZIN; METFORMIN HYDROCHLORIDE; SAXAGLIPTIN HYDROCHLORIDE
TEMIXYS	LAMIVUDINE; TENOFOVIR DISOPROXIL FUMARATE
DOVATO	DOLUTEGRAVIR SODIUM; LAMIVUDINE
RITUXAN HYCELA	RITUXIMAB; HYALURONIDASE (HUMAN RECOMBINANT)
HERCEPTIN HYLECTA	TRASTUZUMAB;HYALURONIDASE-OYSK
